tell us your job in the us	job ( ANS ) , loc ( ANS , locid0 )
what kind of work doe areaid0 have	job ( ANS ) , area ( ANS , areaid0 )
pleas tell me the job to use languageid0 which doe not requir windows.	job ( ANS ) , language ( ANS , languageid0 ) , \+ platform ( ANS , platformid0 )
pleas tell me the work that use excel.	job ( ANS ) , application ( ANS , applicationid0 )
what num_salary job are in locid0 and requir a degre	job ( ANS ) , salary_greater_than ( ANS , num_salary , year ) , loc ( ANS , locid0 ) , req_deg ( ANS )
what kind of work doe companyid0 have	job ( ANS ) , platform ( ANS , platformid0 )
which job do not requir a diploma but use languageid0	job ( ANS ) , \+ req_deg ( ANS ) , language ( ANS , languageid0 )
list job that requir year0 year of experi with languageid0 a degid0	job ( ANS ) , language ( ANS , languageid0 ) , req_deg ( ANS , degid0 ) , req_exp ( ANS , year0 )
pleas tell me the work that use excel.	job ( ANS ) , application ( ANS , applicationid0 )
do you give some work in the solar system locid0	job ( ANS ) , loc ( ANS , locid0 ) , platform ( ANS , platformid0 )
doe locid0 have a job	job ( ANS ) , loc ( ANS , locid0 )
show me a job that doesn t requir java, not austin.	job ( ANS ) , \+ language ( ANS , languageid0 ) , \+ loc ( ANS , locid0 )
what num_salary job are in locid0 that requir degid0	job ( ANS ) , salary_greater_than ( ANS , num_salary , year ) , loc ( ANS , locid0 ) , req_deg ( ANS , degid0 )
what are your non-microsoft job in locid0	job ( ANS ) , loc ( ANS , locid0 ) , \+ company ( ANS , companyid0 )
what kind of work doe languageid0 have	job ( ANS ) , language ( ANS , languageid0 )
what program job doe locid0 use languageid0 have	job ( ANS ) , loc ( ANS , locid0 ) , language ( ANS , languageid0 )
show me locid0 s languageid0 work for two year experi	language ( ANS , languageid0 ) , job ( ANS ) , loc ( ANS , locid0 ) , des_exp ( ANS , year0 )
show me new job in york requir degid0	loc ( ANS , locid0 ) , job ( ANS ) , req_deg ( ANS , degid0 )
what job in locid0 requir a baccalaur	job ( ANS ) , loc ( ANS , locid0 ) , req_deg ( ANS , degid0 )
what job do we do on platformid0 machin	job ( ANS ) , area ( ANS , areaid0 ) , platform ( ANS , platformid0 )
i need one year of experience, but show me the job i want two year of experi	job ( ANS ) , req_exp ( ANS , year0 ) , des_exp ( ANS , year1 )
what kind of work do you have with languageid0	job ( ANS ) , language ( ANS , languageid0 )
show all locid0 areaid0 job	area ( ANS , areaid0 ) , job ( ANS ) , loc ( ANS , locid0 )
what languageid0 job do locid0 s companyid0 have	language ( ANS , languageid0 ) , job ( ANS ) , company ( ANS , companyid0 ) , loc ( ANS , locid0 )
which job pay num_salary that don t requir a doctor	job ( ANS ) , salary_greater_than ( ANS , num_salary , year ) , \+ req_deg ( ANS , degid0 )
which companyid0 job doe degid0 need	job ( ANS ) , company ( ANS , companyid0 ) , req_deg ( ANS , degid0 )
what kind of work do you have with languageid0	job ( ANS ) , language ( ANS , languageid0 )
show me the work of a titleid0 that doe not requir experi in platformid0	title ( ANS , titleid0 ) , job ( ANS ) , \+ ( req_exp ( ANS ) , platform ( ANS , platformid0 ) )
tell us about your work in locid0	job ( ANS ) , loc ( ANS , locid0 )
in which areaid0 posit do you onli need bcscs	area ( ANS , areaid0 ) , job ( ANS ) , req_deg ( ANS , degid0 )
pleas tell me the job that requir bscs.	job ( ANS ) , req_deg ( ANS , degid0 )
what kind of work doe a languageid0 titleid0 who doesn t know languageid1 have	job ( ANS ) , language ( ANS , languageid0 ) , \+ language ( ANS , languageid1 )
what companyid0 posit requir a bsc	job ( ANS ) , company ( ANS , companyid0 ) , req_deg ( ANS , degid0 )
what is more than num_salary job a year that requir degid0	job ( ANS ) , req_deg ( ANS , degid0 ) , salary_greater_than ( ANS , num_salary , year )
show me a job that doesn t requir java, not austin.	job ( ANS ) , \+ language ( ANS , languageid0 ) , \+ loc ( ANS , locid0 )
would you like to list the vm job	job ( ANS ) , platform ( ANS , platformid0 )
doe companyid0 have job that don t requir experi and pay num_salary	job ( ANS ) , company ( ANS , companyid0 ) , \+ req_exp ( ANS ) , salary_greater_than ( ANS , num_salary , year )
show me a job wish mom in locid0 with companyid0	job ( ANS ) , des_deg ( ANS , degid0 ) , loc ( ANS , locid0 ) , company ( ANS , companyid0 )
id want to see a job in locid0 for a prologu titleid0 who prefer at least num_salary areaid0 a year	job ( ANS ) , loc ( ANS , locid0 ) , language ( ANS , languageid0 ) , title ( ANS , titleid0 ) , salary_greater_than ( ANS , num_salary , year ) , area ( ANS , areaid0 )
in locid0 , give me job	job ( ANS ) , loc ( ANS , locid0 )
on the platformid0 , show me the job	job ( ANS ) , platform ( ANS , platformid0 )
what need a degre is locat in locid0 and what job pay num_salary	job ( ANS ) , salary_greater_than ( ANS , num_salary , year ) , loc ( ANS , locid0 ) , req_deg ( ANS )
how about companyid0 , what job are you do	job ( ANS ) , platform ( ANS , platformid0 )
what kind of use languageid0 is the job for locid0	job ( ANS ) , loc ( ANS , locid0 ) , language ( ANS , languageid0 )
platformid0 give me the job	job ( ANS ) , platform ( ANS , platformid0 )
locid0 s experi requir at least year0 year of job	job ( ANS ) , loc ( ANS , locid0 ) , req_exp ( ANS , year0 )
what s a degid0 job in locid0	job ( ANS ) , loc ( ANS , locid0 ) , req_deg ( ANS , degid0 )
in the languageid0 of platformid0 , give me job	job ( ANS ) , platform ( ANS , platformid0 ) , language ( ANS , languageid0 )
in areaid0 s platformid0 , tell me .	job ( ANS ) , platform ( ANS , platformid0 ) , area ( ANS , areaid0 )
about the areaid0 , what kind of job	job ( ANS ) , platform ( ANS , platformid0 ) , area ( ANS , areaid0 )
are there do the areaid0 machin silicon for comput areaid0 , what job	job ( ANS ) , area ( ANS , areaid0 ) , platform ( ANS , platformid0 )
are requir degid0 locid0 there , what job	job ( ANS ) , loc ( ANS , locid0 ) , req_deg ( ANS , degid0 )
for $ num_salary , show me the areaid0 job in locid0	area ( ANS , areaid0 ) , job ( ANS ) , loc ( ANS , locid0 ) , salary_greater_than ( ANS , num_salary , year )
show me the job greater than num_salary per year use languageid0	job ( ANS ) , language ( ANS , languageid0 ) , salary_greater_than ( ANS , num_salary , year )
the job in locid0 , give me	job ( ANS ) , loc ( ANS , locid0 )
is there a pay at least 100 num_salary per year in locid0	job ( ANS ) , loc ( ANS , locid0 ) , salary_greater_than ( ANS , num_salary , year )
for the platformid0 , are there ani comput job	job ( ANS ) , platform ( ANS , platformid0 )
on platformid0 , what is the use of languageid0	job ( ANS ) , language ( ANS , languageid0 ) , platform ( ANS , platformid0 )
locid0 , list job	job ( ANS ) , loc ( ANS , locid0 )
