were there ani job use vc + +	job ( ANS ) , language ( ANS , languageid0 )
is there ani job use vc + +	job ( ANS ) , language ( ANS , languageid0 )
what program job are there outsid locid0 that use languageid0	job ( ANS ) , loc ( ANS , locid0 ) , language ( ANS , languageid0 )
show you locid0 job use languageid0 + + on platformid0	loc ( ANS , locid0 ) , job ( ANS ) , language ( ANS , languageid0 ) , platform ( ANS , platformid0 )
are there ani job that do not requir five year of experi	job ( ANS ) , \+ req_exp ( ANS , year0 )
what job use languageid0 for companyid0 machin and pay num_salary	job ( ANS ) , language ( ANS , languageid0 ) , platform ( ANS , platformid0 ) , salary_greater_than ( ANS , num_salary , year )
what job are there upon companyid0	job ( ANS ) , platform ( ANS , platformid0 )
tell ? the job use vc + +	job ( ANS ) , language ( ANS , languageid0 )
list all job use languageid0 + + and languageid1 for locid0	job ( ANS ) , language ( ANS , languageid0 ) , language ( ANS , languageid1 ) , loc ( ANS , locid0 )
what job are there for companyid0	job ( ANS ) , platform ( ANS , platformid0 )
id like to see the job in locid0 for a languageid0 titleid0 make up least num_salary a year invlov areaid0	job ( ANS ) , loc ( ANS , locid0 ) , language ( ANS , languageid0 ) , title ( ANS , titleid0 ) , salary_greater_than ( ANS , num_salary , year ) , area ( ANS , areaid0 )
what job use languageid0 onto companyid0 machin and pay num_salary	job ( ANS ) , language ( ANS , languageid0 ) , platform ( ANS , platformid0 ) , salary_greater_than ( ANS , num_salary , year )
what job are there insid locid0 requir a degid0	job ( ANS ) , loc ( ANS , locid0 ) , req_deg ( ANS , degid0 )
tell you the job use vc + +	job ( ANS ) , language ( ANS , languageid0 )
what job aren there use vc + +	job ( ANS ) , language ( ANS , languageid0 )
what job in locid0 requir languageid0 + + or platformid0	job ( ANS ) , loc ( ANS , locid0 ) , language ( ANS , languageid0 ) , platform ( ANS , platformid0 )
what job within locid0 requir languageid0 + + and platformid0	job ( ANS ) , loc ( ANS , locid0 ) , language ( ANS , languageid0 ) , platform ( ANS , platformid0 )
what job is there use vc + +	job ( ANS ) , language ( ANS , languageid0 )
list all job use languageid0 + + versus languageid1 in locid0	job ( ANS ) , language ( ANS , languageid0 ) , language ( ANS , languageid1 ) , loc ( ANS , locid0 )
show me locid0 job use languageid0 + + off platformid0	loc ( ANS , locid0 ) , job ( ANS ) , language ( ANS , languageid0 ) , platform ( ANS , platformid0 )
show me locid0 job use languageid0 + + at platformid0	loc ( ANS , locid0 ) , job ( ANS ) , language ( ANS , languageid0 ) , platform ( ANS , platformid0 )
doesn anyon still use platformid0	job ( ANS ) , platform ( ANS , platformid0 )
there must be some job out there for a languageid0 + + titleid0 what think in platformid0 areaid0	job ( ANS ) , language ( ANS , languageid0 ) , title ( ANS , titleid0 ) , platform ( ANS , platformid0 ) , area ( ANS , areaid0 )
what job insid locid0 requir languageid0 + + and platformid0	job ( ANS ) , loc ( ANS , locid0 ) , language ( ANS , languageid0 ) , platform ( ANS , platformid0 )
show me the job that oper onto platformid0	job ( ANS ) , platform ( ANS , platformid0 )
list all job use languageid0 + + / languageid1 in locid0	job ( ANS ) , language ( ANS , languageid0 ) , language ( ANS , languageid1 ) , loc ( ANS , locid0 )
give some job insid locid0 on a platformid0 system	job ( ANS ) , loc ( ANS , locid0 ) , platform ( ANS , platformid0 )
are there ani job that do not requir year0 yearsu experi	job ( ANS ) , \+ req_exp ( ANS , year0 )
show me the job that oper off platformid0	job ( ANS ) , platform ( ANS , platformid0 )
did anyon still use platformid0	job ( ANS ) , platform ( ANS , platformid0 )
aren there ani job use vc + +	job ( ANS ) , language ( ANS , languageid0 )
what are the job in locid0 that requir year0 least year1 year of experi	job ( ANS ) , loc ( ANS , locid0 ) , req_exp ( ANS , year0 )
tell my the job use vc + +	job ( ANS ) , language ( ANS , languageid0 )
are there ani job insid locid0	job ( ANS ) , loc ( ANS , locid0 )
are there ani job that do not requir 25 year of experi	job ( ANS ) , \+ req_exp ( ANS , year0 )
there must be some job out there for a languageid0 + + titleid0 that think insid platformid0 areaid0	job ( ANS ) , language ( ANS , languageid0 ) , title ( ANS , titleid0 ) , platform ( ANS , platformid0 ) , area ( ANS , areaid0 )
there must be some job out there with a languageid0 + + titleid0 that think in platformid0 areaid0	job ( ANS ) , language ( ANS , languageid0 ) , title ( ANS , titleid0 ) , platform ( ANS , platformid0 ) , area ( ANS , areaid0 )
tell i the job use vc + +	job ( ANS ) , language ( ANS , languageid0 )
what job will there use vc + +	job ( ANS ) , language ( ANS , languageid0 )
