use languageid0 ? list job	job ( ANS ) , language ( ANS , languageid0 )
in areaid0 , what job	job ( ANS ) , area ( ANS , areaid0 )
use languageid0 , give me the job	job ( ANS ) , language ( ANS , languageid0 )
which use applicationid0 show me the job	job ( ANS ) , application ( ANS , applicationid0 )
which use applicationid0 show me the job	job ( ANS ) , application ( ANS , applicationid0 )
at companyid0 earn num_salary , show me job	job ( ANS ) , company ( ANS , companyid0 ) , salary_greater_than ( ANS , num_salary , year )
at della earn num_salary , show me job	job ( ANS ) , company ( ANS , companyid0 ) , salary_greater_than ( ANS , num_salary , year )
which use applicationid0 show me the job	job ( ANS ) , application ( ANS , applicationid0 )
which use applicationid0 show me the job	job ( ANS ) , application ( ANS , applicationid0 )
ani job in locid0 is there	job ( ANS ) , loc ( ANS , locid0 )
ani work in locid0 is there	job ( ANS ) , loc ( ANS , locid0 )
do not requirng languageid0 and not in locid0 , show me a job	job ( ANS ) , \+ language ( ANS , languageid0 ) , \+ loc ( ANS , locid0 )
not requirng languageid0 and not in locid0 show me a job	job ( ANS ) , \+ language ( ANS , languageid0 ) , \+ loc ( ANS , locid0 )
the job use languageid0 , give me	job ( ANS ) , language ( ANS , languageid0 )
the job use languageid0 give me	job ( ANS ) , language ( ANS , languageid0 )
in languageid0 , what job are here	job ( ANS ) , language ( ANS , languageid0 )
in languageid0 , what job are	job ( ANS ) , language ( ANS , languageid0 )
use languageid0 , list job	job ( ANS ) , language ( ANS , languageid0 )
a degid0 show me locid0 job	loc ( ANS , locid0 ) , job ( ANS ) , req_deg ( ANS , degid0 )
are requir degid0 locid0 there , what job	job ( ANS ) , loc ( ANS , locid0 ) , req_deg ( ANS , degid0 )
companyid0 job , are ani involv languageid0	job ( ANS ) , company ( ANS , companyid0 ) , language ( ANS , languageid0 )
companyid0 languageid0 job is there ani job	job ( ANS ) , company ( ANS , companyid0 ) , language ( ANS , languageid0 )
what are there use languageid0 , job	job ( ANS ) , language ( ANS , languageid0 )
all of qa job in softwar in locid0 show me	area ( ANS , areaid0 ) , job ( ANS ) , loc ( ANS , locid0 )
ani job on platformid0 are there	job ( ANS ) , platform ( ANS , platformid0 )
for a areaid0 specialist , are there ani job	job ( ANS ) , area ( ANS , areaid0 )
in areaid0 program , show me posit	job ( ANS ) , area ( ANS , areaid0 )
on areaid0 program , show me posit	job ( ANS ) , area ( ANS , areaid0 )
languageid0 use what job are they	job ( ANS ) , language ( ANS , languageid0 )
do not requirng languageid0 and not in locid0 , show me a job	job ( ANS ) , \+ language ( ANS , languageid0 ) , \+ loc ( ANS , locid0 )
not requirng languageid0 and not in locid0 show me a job	job ( ANS ) , \+ language ( ANS , languageid0 ) , \+ loc ( ANS , locid0 )
what are the avail job	job ( ANS )
in locid0 , give me job	job ( ANS ) , loc ( ANS , locid0 )
use languageid0 , give me the job	job ( ANS ) , language ( ANS , languageid0 )
on the platformid0 , show me the job	job ( ANS ) , platform ( ANS , platformid0 )
what need a degre is locat in locid0 and what job pay num_salary	job ( ANS ) , salary_greater_than ( ANS , num_salary , year ) , loc ( ANS , locid0 ) , req_deg ( ANS )
how about companyid0 , what job are you do	job ( ANS ) , platform ( ANS , platformid0 )
areaid0 specialist job , give me job	job ( ANS ) , area ( ANS , areaid0 )
a areaid0 specialist job , give me job	job ( ANS ) , area ( ANS , areaid0 )
what dont requir a degre but use languageid0 are , what job	job ( ANS ) , \+ req_deg ( ANS ) , language ( ANS , languageid0 )
requir languageid0 degid0 year0 year experi list of job	job ( ANS ) , language ( ANS , languageid0 ) , req_deg ( ANS , degid0 ) , req_exp ( ANS , year0 )
in locid0 on the platformid0 system , give some job	job ( ANS ) , loc ( ANS , locid0 ) , platform ( ANS , platformid0 )
ani job with companyid0 is there	job ( ANS ) , company ( ANS , companyid0 )
ani job with companyid0 is there	job ( ANS ) , company ( ANS , companyid0 )
on platformid0 , list job	job ( ANS ) , platform ( ANS , platformid0 )
what kind of use languageid0 is the job for locid0	job ( ANS ) , loc ( ANS , locid0 ) , language ( ANS , languageid0 )
platformid0 give me the job	job ( ANS ) , platform ( ANS , platformid0 )
a num_salary salari is there ani job	job ( ANS ) , salary_greater_than ( ANS , num_salary , year )
locid0 s experi requir at least year0 year of job	job ( ANS ) , loc ( ANS , locid0 ) , req_exp ( ANS , year0 )
what s a degid0 job in locid0	job ( ANS ) , loc ( ANS , locid0 ) , req_deg ( ANS , degid0 )
requir degid0 , tell me job	job ( ANS ) , req_deg ( ANS , degid0 )
requir degid0 , tell me job	job ( ANS ) , req_deg ( ANS , degid0 )
in the languageid0 of platformid0 , give me job	job ( ANS ) , platform ( ANS , platformid0 ) , language ( ANS , languageid0 )
in areaid0 s platformid0 , tell me .	job ( ANS ) , platform ( ANS , platformid0 ) , area ( ANS , areaid0 )
about the areaid0 , what kind of job	job ( ANS ) , platform ( ANS , platformid0 ) , area ( ANS , areaid0 )
for languageid0 titleid0 in locid0 , what kind of job are avail	job ( ANS ) , language ( ANS , languageid0 ) , title ( ANS , titleid0 ) , loc ( ANS , locid0 )
use languageid0 , show the job	job ( ANS ) , language ( ANS , languageid0 )
are there do the areaid0 machin silicon for comput areaid0 , what job	job ( ANS ) , area ( ANS , areaid0 ) , platform ( ANS , platformid0 )
are requir degid0 locid0 there , what job	job ( ANS ) , loc ( ANS , locid0 ) , req_deg ( ANS , degid0 )
in locid0 , give me job .	job ( ANS ) , loc ( ANS , locid0 )
that pay num_salary per year , what are the job	job ( ANS ) , salary_greater_than ( ANS , num_salary , year )
for $ num_salary , show me the areaid0 job in locid0	area ( ANS , areaid0 ) , job ( ANS ) , loc ( ANS , locid0 ) , salary_greater_than ( ANS , num_salary , year )
show me the job greater than num_salary per year use languageid0	job ( ANS ) , language ( ANS , languageid0 ) , salary_greater_than ( ANS , num_salary , year )
in locid0 , tell me job	job ( ANS ) , loc ( ANS , locid0 )
the job in locid0 , give me	job ( ANS ) , loc ( ANS , locid0 )
is there a pay at least 100 num_salary per year in locid0	job ( ANS ) , loc ( ANS , locid0 ) , salary_greater_than ( ANS , num_salary , year )
for the platformid0 , are there ani comput job	job ( ANS ) , platform ( ANS , platformid0 )
on platformid0 , what is the use of languageid0	job ( ANS ) , language ( ANS , languageid0 ) , platform ( ANS , platformid0 )
requir degid0 , tell me job	job ( ANS ) , req_deg ( ANS , degid0 )
for a areaid0 specialist , tell me job	job ( ANS ) , area ( ANS , areaid0 )
locid0 , list job	job ( ANS ) , loc ( ANS , locid0 )
on platformid0 , show the job	job ( ANS ) , platform ( ANS , platformid0 )
