know me what job there are	job ( ANS )
what role do you have	job ( ANS )
ask me what job there are	job ( ANS )
tell me what job there are	job ( ANS )
what job do you have	job ( ANS )
tell me the employ in locid0	job ( ANS ) , loc ( ANS , locid0 )
get me job in locid0	job ( ANS ) , loc ( ANS , locid0 )
list employ in locid0	job ( ANS ) , loc ( ANS , locid0 )
make me job in locid0	job ( ANS ) , loc ( ANS , locid0 )
take me job in locid0	job ( ANS ) , loc ( ANS , locid0 )
list job util languageid0	job ( ANS ) , language ( ANS , languageid0 )
list the job use languageid0	job ( ANS ) , language ( ANS , languageid0 )
get me the job use languageid0	job ( ANS ) , language ( ANS , languageid0 )
what job are there use languageid0	job ( ANS ) , language ( ANS , languageid0 )
list the job use languageid0	job ( ANS ) , language ( ANS , languageid0 )
give me the job use languageid0	job ( ANS ) , language ( ANS , languageid0 )
what job are there use languageid0	job ( ANS ) , language ( ANS , languageid0 )
list the job util languageid0	job ( ANS ) , language ( ANS , languageid0 )
what job are there util languageid0	job ( ANS ) , language ( ANS , languageid0 )
are there ani job for a areaid0 specialist	job ( ANS ) , area ( ANS , areaid0 )
give me the job util languageid0 that dont requir platformid0	job ( ANS ) , language ( ANS , languageid0 ) , \+ platform ( ANS , platformid0 )
get me the job use languageid0 that dont requir platformid0	job ( ANS ) , language ( ANS , languageid0 ) , \+ platform ( ANS , platformid0 )
tell me the job which use applicationid0	job ( ANS ) , application ( ANS , applicationid0 )
tell me job on platformid0	job ( ANS ) , platform ( ANS , platformid0 )
tell me the job that oper on platformid0	job ( ANS ) , platform ( ANS , platformid0 )
give me job at companyid0 earn num_salary	job ( ANS ) , company ( ANS , companyid0 ) , salary_greater_than ( ANS , num_salary , year )
what job paid num_salary are locat in locid0 and requir a degre	job ( ANS ) , salary_greater_than ( ANS , num_salary , year ) , loc ( ANS , locid0 ) , req_deg ( ANS )
show me job util languageid0 that requir a degid0 and desir a degid1	job ( ANS ) , language ( ANS , languageid0 ) , req_deg ( ANS , degid0 ) , des_deg ( ANS , degid1 )
show me job use languageid0 that need a degid0 and desir a degid1	job ( ANS ) , language ( ANS , languageid0 ) , req_deg ( ANS , degid0 ) , des_deg ( ANS , degid1 )
what job are there that dont requir a degre but util languageid0	job ( ANS ) , \+ req_deg ( ANS ) , language ( ANS , languageid0 )
tell me the job which use applicationid0	job ( ANS ) , application ( ANS , applicationid0 )
take some job in locid0 on a platformid0 system	job ( ANS ) , loc ( ANS , locid0 ) , platform ( ANS , platformid0 )
make some job in locid0 on a platformid0 system	job ( ANS ) , loc ( ANS , locid0 ) , platform ( ANS , platformid0 )
are there ani employ with companyid0	job ( ANS ) , company ( ANS , companyid0 )
are there ani posit with companyid0	job ( ANS ) , company ( ANS , companyid0 )
give me a job not requirng languageid0 and not in locid0	job ( ANS ) , \+ language ( ANS , languageid0 ) , \+ loc ( ANS , locid0 )
what are the job util languageid0 with salari of num_salary	job ( ANS ) , language ( ANS , languageid0 ) , salary_greater_than ( ANS , num_salary , year )
are there ani job in languageid0 that the salari is num_salary	job ( ANS ) , language ( ANS , languageid0 ) , salary_greater_than ( ANS , num_salary , year )
are present ani job in languageid0 that the salari is num_salary	job ( ANS ) , language ( ANS , languageid0 ) , salary_greater_than ( ANS , num_salary , year )
are there ani posit in languageid0 that the salari is num_salary	job ( ANS ) , language ( ANS , languageid0 ) , salary_greater_than ( ANS , num_salary , year )
are there ani job use languageid0 that dont need a degid0	job ( ANS ) , language ( ANS , languageid0 ) , \+ req_deg ( ANS , degid0 )
what employ are in locid0 that are not at companyid0	job ( ANS ) , loc ( ANS , locid0 ) , \+ company ( ANS , companyid0 )
are there ani posit with a salari of num_salary	job ( ANS ) , salary_greater_than ( ANS , num_salary , year )
what are the job that paid num_salary per year	job ( ANS ) , salary_greater_than ( ANS , num_salary , year )
are there ani employ with a salari of num_salary	job ( ANS ) , salary_greater_than ( ANS , num_salary , year )
what are the job in locid0 that need at least year0 year of experi	job ( ANS ) , loc ( ANS , locid0 ) , req_exp ( ANS , year0 )
what are the posit within companyid0 that requir degid0	job ( ANS ) , company ( ANS , companyid0 ) , req_deg ( ANS , degid0 )
are there ani job at companyid0 that need a degid0	job ( ANS ) , company ( ANS , companyid0 ) , req_deg ( ANS , degid0 )
which job need knowldg of languageid0 but dont special in areaid0	job ( ANS ) , language ( ANS , languageid0 ) , \+ area ( ANS , areaid0 )
make me the job on platformid0 in languageid0	job ( ANS ) , platform ( ANS , platformid0 ) , language ( ANS , languageid0 )
get me the job on platformid0 in languageid0	job ( ANS ) , platform ( ANS , platformid0 ) , language ( ANS , languageid0 )
what job are there conduct comput areaid0 on platformid0 machin	job ( ANS ) , area ( ANS , areaid0 ) , platform ( ANS , platformid0 )
what job are there perform comput areaid0 on platformid0 machin	job ( ANS ) , area ( ANS , areaid0 ) , platform ( ANS , platformid0 )
show me job that requir year0 year job experi in languageid0	job ( ANS ) , req_exp ( ANS , year0 ) , language ( ANS , languageid0 )
are there ani job with companyid0 concern languageid0	job ( ANS ) , company ( ANS , companyid0 ) , language ( ANS , languageid0 )
show me all of the areaid0 employ in locid0	area ( ANS , areaid0 ) , job ( ANS ) , loc ( ANS , locid0 )
show me the areaid0 employ in locid0 with a salari of num_salary	area ( ANS , areaid0 ) , job ( ANS ) , loc ( ANS , locid0 ) , salary_greater_than ( ANS , num_salary , year )
show me the areaid0 career in locid0 with a salari of num_salary	area ( ANS , areaid0 ) , job ( ANS ) , loc ( ANS , locid0 ) , salary_greater_than ( ANS , num_salary , year )
show me titleid0 job need no experi on platformid0	title ( ANS , titleid0 ) , job ( ANS ) , \+ ( req_exp ( ANS ) , platform ( ANS , platformid0 ) )
give me titleid0 job requir no experi on platformid0	title ( ANS , titleid0 ) , job ( ANS ) , \+ ( req_exp ( ANS ) , platform ( ANS , platformid0 ) )
what are the posit within companyid0 that requir degid0	job ( ANS ) , company ( ANS , companyid0 ) , req_deg ( ANS , degid0 )
are there ani job at companyid0 that need a degid0	job ( ANS ) , company ( ANS , companyid0 ) , req_deg ( ANS , degid0 )
show all titleid0 job in locid0 with areaid0 and languageid0	title ( ANS , titleid0 ) , job ( ANS ) , loc ( ANS , locid0 ) , area ( ANS , areaid0 ) , language ( ANS , languageid0 )
what job in locid0 are there that paid at least num_salary per year	job ( ANS ) , loc ( ANS , locid0 ) , salary_greater_than ( ANS , num_salary , year )
what can i found use languageid0 on platformid0	job ( ANS ) , language ( ANS , languageid0 ) , platform ( ANS , platformid0 )
what job are there for languageid0 program who dont knew languageid1	job ( ANS ) , language ( ANS , languageid0 ) , \+ language ( ANS , languageid1 )
what job need a degid0 and pay more than num_salary per year	job ( ANS ) , req_deg ( ANS , degid0 ) , salary_greater_than ( ANS , num_salary , year )
give me a job not requirng languageid0 and not in locid0	job ( ANS ) , \+ language ( ANS , languageid0 ) , \+ loc ( ANS , locid0 )
are there ani posit at companyid0 that requir no experi and pay num_salary	job ( ANS ) , company ( ANS , companyid0 ) , \+ req_exp ( ANS ) , salary_greater_than ( ANS , num_salary , year )
are there ani job at companyid0 that need no experi and pay num_salary	job ( ANS ) , company ( ANS , companyid0 ) , \+ req_exp ( ANS ) , salary_greater_than ( ANS , num_salary , year )
tell me job desir a degid0 in locid0 with companyid0	job ( ANS ) , des_deg ( ANS , degid0 ) , loc ( ANS , locid0 ) , company ( ANS , companyid0 )
show me locid0 job util languageid0 on platformid0	loc ( ANS , locid0 ) , job ( ANS ) , language ( ANS , languageid0 ) , platform ( ANS , platformid0 )
tell me locid0 job desir a degid0	loc ( ANS , locid0 ) , job ( ANS ) , des_deg ( ANS , degid0 )
give me locid0 job desir a degid0	loc ( ANS , locid0 ) , job ( ANS ) , des_deg ( ANS , degid0 )
