what are the main river of s0	( lambda $0 e ( and ( major:t $0 ) ( river:t $0 ) ( loc:t $0 s0 ) ) )
where is the smallest town	( lambda $0 e ( loc:t ( argmin $1 ( city:t $1 ) ( size:i $1 ) ) $0 ) )
which river flow through the state border the state c0	( lambda $0 e ( and ( river:t $0 ) ( exists $1 ( and ( state:t $1 ) ( next_to:t $1 ( the $2 ( and ( state:t $2 ) ( capital:t $2 c0 ) ) ) ) ( loc:t $0 $1 ) ) ) ) )
in which state the r0 flow	( lambda $0 e ( and ( state:t $0 ) ( loc:t r0 $0 ) ) )
what is the state popul of the r0 river?	( lambda $0 e ( exists $1 ( and ( state:t $1 ) ( loc:t r0 $1 ) ( population:t $1 $0 ) ) ) )
state surround s0	( lambda $0 e ( and ( state:t $0 ) ( next_to:t $0 s0 ) ) )
how mani citi in co0	( count $0 ( and ( city:t $0 ) ( loc:t $0 co0 ) ) )
what is s0 largest citi	( argmax $0 ( and ( city:t $0 ) ( loc:t $0 s0 ) ) ( size:i $0 ) )
most popul state	( argmax $0 ( state:t $0 ) ( population:i $0 ) )
what is the popul of houston?	( population:i c0 )
which is the longest river in the state border s0	( argmax $0 ( and ( river:t $0 ) ( exists $1 ( and ( state:t $1 ) ( next_to:t $1 s0 ) ( loc:t $0 $1 ) ) ) ) ( len:i $0 ) )
where is the capit of s0	( capital:c s0 )
how mani peopl live in new york&#39; largest city?	( population:i ( argmax $0 ( and ( city:t $0 ) ( loc:t $0 s0 ) ) ( size:i $0 ) ) )
where is the capit of the state neighbor to s0	( lambda $0 e ( and ( capital:t $0 ) ( exists $1 ( and ( state:t $1 ) ( next_to:t $1 s0 ) ( loc:t $0 $1 ) ) ) ) )
what is the best point in the state with the capit c0	( argmax $0 ( and ( place:t $0 ) ( loc:t $0 ( the $1 ( and ( state:t $1 ) ( capital:t $1 c0 ) ) ) ) ) ( elevation:i $0 ) )
state with the largest capit	( lambda $0 e ( and ( state:t $0 ) ( loc:t ( argmax $1 ( capital:t $1 ) ( size:i $1 ) ) $0 ) ) )
what is the state capit of s0	( capital:c s0 )
which state has the largest citi	( argmax $0 ( state:t $0 ) ( count $1 ( and ( city:t $1 ) ( major:t $1 ) ( loc:t $1 $0 ) ) ) )
state with a citi n0	( lambda $0 e ( and ( state:t $0 ) ( exists $1 ( and ( city:t $1 ) ( named:t $1 n0 ) ( loc:t $1 $0 ) ) ) ) )
what is the smallest citi in co0	( argmin $0 ( and ( city:t $0 ) ( loc:t $0 co0 ) ) ( size:i $0 ) )
what is the popul of hawaii?	( population:i s0 )
how mani state doe co0 have?	( count $0 ( and ( state:t $0 ) ( loc:t $0 co0 ) ) )
what state is the longest river	( lambda $0 e ( and ( state:t $0 ) ( loc:t ( argmax $1 ( river:t $1 ) ( len:i $1 ) ) $0 ) ) )
tell me which state border s0	( lambda $0 e ( and ( state:t $0 ) ( next_to:t $0 s0 ) ) )
state with a citi n0	( lambda $0 e ( and ( state:t $0 ) ( exists $1 ( and ( city:t $1 ) ( named:t $1 n0 ) ( loc:t $1 $0 ) ) ) ) )
how mani citizen are the largest citi in the unit states?	( population:i ( argmax $0 ( and ( city:t $0 ) ( loc:t $0 co0 ) ) ( size:i $0 ) ) )
how mani peopl live in utah?	( population:i s0 )
river flow in s0	( lambda $0 e ( and ( river:t $0 ) ( loc:t $0 s0 ) ) )
river flow through most state	( argmax $0 ( river:t $0 ) ( count $1 ( and ( state:t $1 ) ( loc:t $0 $1 ) ) ) )
what river doe s0 have	( lambda $0 e ( and ( river:t $0 ) ( loc:t $0 s0 ) ) )
state with highest point	( lambda $0 e ( and ( state:t $0 ) ( loc:t ( argmax $1 ( place:t $1 ) ( elevation:i $1 ) ) $0 ) ) )
how long is r0	( len:i r0 )
where is the capit of s0	( capital:c s0 )
state with most major river	( argmax $0 ( state:t $0 ) ( count $1 ( and ( major:t $1 ) ( river:t $1 ) ( loc:t $1 $0 ) ) ) )
where is the capit of s0	( capital:c s0 )
how mani riverless state are there?	( count $0 ( and ( state:t $0 ) ( not ( exists $1 ( and ( river:t $1 ) ( loc:t $1 $0 ) ) ) ) ) )
how high is mckinley mount	( elevation:i m0 )
tell me how mani river in s0	( count $0 ( and ( river:t $0 ) ( loc:t $0 s0 ) ) )
what are the major citi of s0	( lambda $0 e ( and ( major:t $0 ) ( city:t $0 ) ( loc:t $0 s0 ) ) )
the total area of all 50 state is	( sum $0 ( state:t $0 ) ( area:i $0 ) )
what river doe s0 have	( lambda $0 e ( and ( river:t $0 ) ( loc:t $0 s0 ) ) )
what are the big citi in s0	( lambda $0 e ( and ( major:t $0 ) ( city:t $0 ) ( loc:t $0 s0 ) ) )
state with the largest popul	( argmax $0 ( state:t $0 ) ( population:i $0 ) )
what is the highlight of the border state of s0	( argmax $0 ( and ( place:t $0 ) ( exists $1 ( and ( state:t $1 ) ( next_to:t $1 s0 ) ( loc:t $0 $1 ) ) ) ) ( elevation:i $0 ) )
what is the highlight of s0	( argmax $0 ( and ( place:t $0 ) ( loc:t $0 s0 ) ) ( elevation:i $0 ) )
what is the popul of the state in which s0 is run	( lambda $0 e ( exists $1 ( and ( state:t $1 ) ( loc:t r0 $1 ) ( population:t $1 $0 ) ) ) )
where is the capit of s0	( capital:c s0 )
state capit with the least popul	( argmin $0 ( capital:t $0 ) ( population:i $0 ) )
state border s0	( lambda $0 e ( and ( state:t $0 ) ( next_to:t $0 s0 ) ) )
which is the smallest border state of s0	( argmin $0 ( and ( state:t $0 ) ( next_to:t $0 s0 ) ) ( size:i $0 ) )
state border s0	( lambda $0 e ( and ( state:t $0 ) ( next_to:t $0 s0 ) ) )
what is the highlight of the co0	( argmax $0 ( and ( place:t $0 ) ( loc:t $0 co0 ) ) ( elevation:i $0 ) )
how mani peopl live in co0	( population:i co0 )
where is the lowest point of s0	( lambda $0 e ( loc:t ( argmin $1 ( and ( place:t $1 ) ( loc:t $1 s0 ) ) ( elevation:i $1 ) ) $0 ) )
the number of state neighbor to the state with the largest popul	( count $0 ( and ( state:t $0 ) ( next_to:t $0 ( argmax $1 ( state:t $1 ) ( population:i $1 ) ) ) ) )
state with largest area	( argmax $0 ( state:t $0 ) ( area:i $0 ) )
r0 length	( len:i r0 )
where is the capit of s0	( capital:c s0 )
state with a citi n0	( lambda $0 e ( and ( state:t $0 ) ( exists $1 ( and ( city:t $1 ) ( named:t $1 n0 ) ( loc:t $1 $0 ) ) ) ) )
how mani river are in the state with the most rivers?	( count $0 ( and ( river:t $0 ) ( loc:t $0 ( argmax $1 ( state:t $1 ) ( count $2 ( and ( river:t $2 ) ( loc:t $2 $1 ) ) ) ) ) ) )
how long are the river that flow in most state	( len:i ( argmax $0 ( river:t $0 ) ( count $1 ( and ( state:t $1 ) ( loc:t $0 $1 ) ) ) ) )
what are the capit in s0	( lambda $0 e ( and ( capital:t $0 ) ( loc:t $0 s0 ) ( city:t $0 ) ) )
which state with the largest area	( argmax $0 ( state:t $0 ) ( area:i $0 ) )
what is the smallest citi in co0	( argmin $0 ( and ( city:t $0 ) ( loc:t $0 co0 ) ) ( size:i $0 ) )
what is the largest citi in s0	( argmax $0 ( and ( city:t $0 ) ( loc:t $0 s0 ) ) ( size:i $0 ) )
which is the longest river in s0	( argmax $0 ( and ( river:t $0 ) ( loc:t $0 s0 ) ) ( len:i $0 ) )
what is the popul of s0	( population:i c0 )
what is the largest citi in the smallest state in co0	( argmax $0 ( and ( city:t $0 ) ( loc:t $0 ( argmin $1 ( and ( state:t $1 ) ( loc:t $1 co0 ) ) ( size:i $1 ) ) ) ) ( size:i $0 ) )
what are the major citi in pennsylvania?	( lambda $0 e ( and ( major:t $0 ) ( city:t $0 ) ( loc:t $0 s0 ) ) )
what is the river in s0	( lambda $0 e ( and ( river:t $0 ) ( loc:t $0 s0 ) ) )
what is the state citi with the highest points?	( lambda $0 e ( and ( city:t $0 ) ( loc:t $0 ( the $1 ( and ( state:t $1 ) ( loc:t ( argmax $2 ( place:t $2 ) ( elevation:i $2 ) ) $1 ) ) ) ) ) )
what is our highest mountain	( argmax $0 ( and ( mountain:t $0 ) ( loc:t $0 co0 ) ) ( elevation:i $0 ) )
where is the highest mountain in the co0	( lambda $0 e ( loc:t ( argmax $1 ( and ( mountain:t $1 ) ( loc:t $1 co0 ) ) ( elevation:i $1 ) ) $0 ) )
in which state the r0 flow	( lambda $0 e ( and ( state:t $0 ) ( loc:t r0 $0 ) ) )
what is the highest point in co0	( elevation:i ( argmax $0 ( and ( place:t $0 ) ( loc:t $0 co0 ) ) ( elevation:i $0 ) ) )
most popul citi	( argmax $0 ( city:t $0 ) ( population:i $0 ) )
what is the highest altitud in san francisco?	( argmax $0 ( and ( place:t $0 ) ( loc:t $0 c0 ) ) ( elevation:i $0 ) )
what is the highlight of s0	( argmax $0 ( and ( place:t $0 ) ( loc:t $0 s0 ) ) ( elevation:i $0 ) )
how long is california&#39; longest river	( len:i ( argmax $0 ( and ( river:t $0 ) ( loc:t $0 s0 ) ) ( len:i $0 ) ) )
river that do not flow through s0	( lambda $0 e ( and ( river:t $0 ) ( not ( loc:t $0 s0 ) ) ) )
what is the lowest point in co0	( argmin $0 ( and ( place:t $0 ) ( loc:t $0 co0 ) ) ( elevation:i $0 ) )
what is the largest state border s0	( argmax $0 ( and ( state:t $0 ) ( next_to:t $0 s0 ) ) ( size:i $0 ) )
how mani peopl live in c0 minnesota?	( population:i c0 )
name all river in s0	( lambda $0 e ( and ( river:t $0 ) ( loc:t $0 s0 ) ) )
how long is the longest river in co0	( len:i ( argmax $0 ( and ( river:t $0 ) ( loc:t $0 co0 ) ) ( len:i $0 ) ) )
river that cross most state	( argmax $0 ( river:t $0 ) ( count $1 ( and ( state:t $1 ) ( loc:t $0 $1 ) ) ) )
state with the longest river	( lambda $0 e ( and ( state:t $0 ) ( loc:t ( argmax $1 ( river:t $1 ) ( len:i $1 ) ) $0 ) ) )
what is the highest mountain in the co0	( argmax $0 ( and ( mountain:t $0 ) ( loc:t $0 co0 ) ) ( elevation:i $0 ) )
number of peopl live in s0	( population:i s0 )
what are all s0 river	( lambda $0 e ( and ( river:t $0 ) ( loc:t $0 s0 ) ) )
which state is the least popul	( argmin $0 ( state:t $0 ) ( population:i $0 ) )
the highest state popul densiti	( density:i ( argmax $0 ( state:t $0 ) ( size:i $0 ) ) )
in what state is mount mckinley?	( lambda $0 e ( and ( state:t $0 ) ( loc:t m0 $0 ) ) )
river flow through most state	( argmax $0 ( river:t $0 ) ( count $1 ( and ( state:t $1 ) ( loc:t $0 $1 ) ) ) )
which are the main citi of the state cross by the r0	( lambda $0 e ( and ( major:t $0 ) ( city:t $0 ) ( exists $1 ( and ( state:t $1 ) ( loc:t r0 $1 ) ( loc:t $0 $1 ) ) ) ) )
what is the highest altitud in s0	( argmax $0 ( and ( place:t $0 ) ( loc:t $0 s0 ) ) ( elevation:i $0 ) )
state border s0	( lambda $0 e ( and ( state:t $0 ) ( next_to:t $0 s0 ) ) )
how long doe the r0	( len:i r0 )
which state has a citi name salt lake city?	( lambda $0 e ( and ( state:t $0 ) ( exists $1 ( and ( city:t $1 ) ( named:t $1 n0 ) ( loc:t $1 $0 ) ) ) ) )
what are the big citi of s0	( lambda $0 e ( and ( major:t $0 ) ( city:t $0 ) ( loc:t $0 s0 ) ) )
how mani state doe co0 have?	( count $0 ( and ( state:t $0 ) ( loc:t $0 co0 ) ) )
