which area is the smallest	( argmin $0 ( state:t $0 ) ( size:i $0 ) )
which is the longest river in nation	( argmax $0 ( and ( river:t $0 ) ( loc:t $0 co0 ) ) ( len:i $0 ) )
nicknam the major river in s0	( lambda $0 e ( and ( major:t $0 ) ( river:t $0 ) ( loc:t $0 s0 ) ) )
name the major river in s0	( lambda $0 e ( and ( major:t $0 ) ( river:t $0 ) ( loc:t $0 s0 ) ) )
what is the popul of c0	( population:i c0 )
which state has the lowest demograph densiti	( argmin $0 ( state:t $0 ) ( density:i $0 ) )
what state has the lowest demograph densiti	( argmin $0 ( state:t $0 ) ( density:i $0 ) )
what state has the lowest popul densiti	( argmin $0 ( state:t $0 ) ( density:i $0 ) )
what is the lowest point in s0	( argmin $0 ( and ( place:t $0 ) ( loc:t $0 s0 ) ) ( elevation:i $0 ) )
what is the popul of s0	( population:i s0 )
what is the populac of s0	( population:i s0 )
what is the demograph of s0	( population:i s0 )
which state doe the r0 run through	( lambda $0 e ( and ( state:t $0 ) ( loc:t r0 $0 ) ) )
what state doe the r0 pass through	( lambda $0 e ( and ( state:t $0 ) ( loc:t r0 $0 ) ) )
how mani peopl live in c0	( population:i c0 )
how mani person live in c0	( population:i c0 )
what is the popul of c0	( population:i c0 )
how mani peopl live in c0	( population:i c0 )
what are the popul of state through which the r0 flow	( lambda $0 e ( exists $1 ( and ( state:t $1 ) ( loc:t r0 $1 ) ( population:t $1 $0 ) ) ) )
what are the popul of state through which the r0 run	( lambda $0 e ( exists $1 ( and ( state:t $1 ) ( loc:t r0 $1 ) ( population:t $1 $0 ) ) ) )
what are the popul of state through which the r0 run	( lambda $0 e ( exists $1 ( and ( state:t $1 ) ( loc:t r0 $1 ) ( population:t $1 $0 ) ) ) )
what state doe the r0 run through	( lambda $0 e ( and ( state:t $0 ) ( loc:t r0 $0 ) ) )
what state doe the r0 run through	( lambda $0 e ( and ( state:t $0 ) ( loc:t r0 $0 ) ) )
what state is the largest in populac	( argmax $0 ( state:t $0 ) ( population:i $0 ) )
which state has the most populac	( argmax $0 ( state:t $0 ) ( population:i $0 ) )
what state is the largest in demograph	( argmax $0 ( state:t $0 ) ( population:i $0 ) )
what is the most popul state	( argmax $0 ( state:t $0 ) ( population:i $0 ) )
what state surround s0	( lambda $0 e ( and ( state:t $0 ) ( next_to:t $0 s0 ) ) )
what state border s0	( lambda $0 e ( and ( state:t $0 ) ( next_to:t $0 s0 ) ) )
what is the capit of s0	( capital:c s0 )
how mani citi are here in the co0	( count $0 ( and ( city:t $0 ) ( loc:t $0 co0 ) ) )
how mani citi are there in the u state	( count $0 ( and ( city:t $0 ) ( loc:t $0 co0 ) ) )
what are the popul of state which border s0	( lambda $0 e ( exists $1 ( and ( state:t $1 ) ( next_to:t $1 s0 ) ( population:t $1 $0 ) ) ) )
what is the largest citi in s0	( argmax $0 ( and ( city:t $0 ) ( loc:t $0 s0 ) ) ( size:i $0 ) )
what is the popul of c0	( population:i c0 )
what is the populac of c0	( population:i c0 )
what is the longest river that stream through a state that border s0	( argmax $0 ( and ( river:t $0 ) ( exists $1 ( and ( state:t $1 ) ( next_to:t $1 s0 ) ( loc:t $0 $1 ) ) ) ) ( len:i $0 ) )
what is the capit of s0	( capital:c s0 )
which co0 has the most major citi	( argmax $0 ( state:t $0 ) ( count $1 ( and ( major:t $1 ) ( city:t $1 ) ( loc:t $1 $0 ) ) ) )
which counti has the most major citi	( argmax $0 ( state:t $0 ) ( count $1 ( and ( major:t $1 ) ( city:t $1 ) ( loc:t $1 $0 ) ) ) )
which state has the most major citi	( argmax $0 ( state:t $0 ) ( count $1 ( and ( major:t $1 ) ( city:t $1 ) ( loc:t $1 $0 ) ) ) )
what is the highest elev in the u state	( argmax $0 ( and ( place:t $0 ) ( loc:t $0 co0 ) ) ( elevation:i $0 ) )
what is the highest point in the co0	( argmax $0 ( and ( place:t $0 ) ( loc:t $0 co0 ) ) ( elevation:i $0 ) )
what is the highest elev in the unit s	( argmax $0 ( and ( place:t $0 ) ( loc:t $0 co0 ) ) ( elevation:i $0 ) )
how mani peopl live in the biggest citi in s0	( population:i ( argmax $0 ( and ( city:t $0 ) ( loc:t $0 s0 ) ) ( size:i $0 ) ) )
what are the capit of state that border s0	( lambda $0 e ( and ( capital:t $0 ) ( exists $1 ( and ( state:t $1 ) ( next_to:t $1 s0 ) ( loc:t $0 $1 ) ) ) ) )
what is the length of the river that flow through the most state	( len:i ( argmax $0 ( river:t $0 ) ( count $1 ( and ( state:t $1 ) ( loc:t $0 $1 ) ) ) ) )
what is the highest point in the state with capit c0	( argmax $0 ( and ( place:t $0 ) ( loc:t $0 ( the $1 ( and ( state:t $1 ) ( capital:t $1 c0 ) ) ) ) ) ( elevation:i $0 ) )
what is the highest point in the state with capit c0	( argmax $0 ( and ( place:t $0 ) ( loc:t $0 ( the $1 ( and ( state:t $1 ) ( capital:t $1 c0 ) ) ) ) ) ( elevation:i $0 ) )
what state has the biggest capit	( lambda $0 e ( and ( state:t $0 ) ( loc:t ( argmax $1 ( capital:t $1 ) ( size:i $1 ) ) $0 ) ) )
what is the princip of s0	( capital:c s0 )
what state border s0	( lambda $0 e ( and ( state:t $0 ) ( next_to:t $0 s0 ) ) )
what state border state that the r0 run through	( lambda $0 e ( and ( state:t $0 ) ( exists $1 ( and ( state:t $1 ) ( loc:t r0 $1 ) ( next_to:t $0 $1 ) ) ) ) )
what state border state that the r0 run through	( lambda $0 e ( and ( state:t $0 ) ( exists $1 ( and ( state:t $1 ) ( loc:t r0 $1 ) ( next_to:t $0 $1 ) ) ) ) )
which state has the highest elev	( argmax $1 ( state:t $1 ) ( elevation:i $1 ) )
what is the most popul state through which the r0 run	( argmax $0 ( and ( state:t $0 ) ( loc:t r0 $0 ) ) ( population:i $0 ) )
what state has the most major citi	( argmax $0 ( state:t $0 ) ( count $1 ( and ( city:t $1 ) ( major:t $1 ) ( loc:t $1 $0 ) ) ) )
what citi has the most major citi	( argmax $0 ( state:t $0 ) ( count $1 ( and ( city:t $1 ) ( major:t $1 ) ( loc:t $1 $0 ) ) ) )
what is the highest point of the state with the smallest populac densiti	( argmax $0 ( and ( place:t $0 ) ( loc:t $0 ( argmin $1 ( state:t $1 ) ( density:i $1 ) ) ) ) ( elevation:i $0 ) )
what is the smallest citi in the co0	( argmin $0 ( and ( city:t $0 ) ( loc:t $0 co0 ) ) ( size:i $0 ) )
what is the smallest metropoli in the co0	( argmin $0 ( and ( city:t $0 ) ( loc:t $0 co0 ) ) ( size:i $0 ) )
what is the popul of s0	( population:i s0 )
what state border s0	( lambda $0 e ( and ( state:t $0 ) ( next_to:t $0 s0 ) ) )
how mani state doe co0 have	( count $0 ( and ( state:t $0 ) ( loc:t $0 co0 ) ) )
how mani state are they in the co0	( count $0 ( and ( state:t $0 ) ( loc:t $0 co0 ) ) )
how mani state are there in the co0	( count $0 ( and ( state:t $0 ) ( loc:t $0 co0 ) ) )
how long is the r0 waterway	( len:i r0 )
what is the length of the r0 river	( len:i r0 )
what is the length of the r0 stream	( len:i r0 )
which state doe the longest river run through	( lambda $0 e ( and ( state:t $0 ) ( loc:t ( argmax $1 ( river:t $1 ) ( len:i $1 ) ) $0 ) ) )
what state has the longest river	( lambda $0 e ( and ( state:t $0 ) ( loc:t ( argmax $1 ( river:t $1 ) ( len:i $1 ) ) $0 ) ) )
get me the state that border s0	( lambda $0 e ( and ( state:t $0 ) ( next_to:t $0 s0 ) ) )
take me the state that border s0	( lambda $0 e ( and ( state:t $0 ) ( next_to:t $0 s0 ) ) )
what is the capit of the state with the biggest popul densiti	( capital:c ( argmax $1 ( state:t $1 ) ( density:i $1 ) ) )
what is the capit of the state with the largest popul densiti	( capital:c ( argmax $1 ( state:t $1 ) ( density:i $1 ) ) )
what state have citi titl plano	( lambda $0 e ( and ( state:t $0 ) ( exists $1 ( and ( city:t $1 ) ( named:t $1 n0 ) ( loc:t $1 $0 ) ) ) ) )
what state have citi n0	( lambda $0 e ( and ( state:t $0 ) ( exists $1 ( and ( city:t $1 ) ( named:t $1 n0 ) ( loc:t $1 $0 ) ) ) ) )
what citi border the state with the most citi	( lambda $0 e ( and ( state:t $0 ) ( next_to:t $0 ( argmax $1 ( state:t $1 ) ( count $2 ( and ( city:t $2 ) ( loc:t $2 $1 ) ) ) ) ) ) )
how mani citizen doe the biggest citi have in the co0	( population:i ( argmax $0 ( and ( city:t $0 ) ( loc:t $0 co0 ) ) ( size:i $0 ) ) )
how mani peopl doe the biggest citi have in the co0	( population:i ( argmax $0 ( and ( city:t $0 ) ( loc:t $0 co0 ) ) ( size:i $0 ) ) )
how mani person live in s0	( population:i s0 )
what river stream through s0	( lambda $0 e ( and ( river:t $0 ) ( loc:t $0 s0 ) ) )
river in s0	( lambda $0 e ( and ( river:t $0 ) ( loc:t $0 s0 ) ) )
what river run through s0	( lambda $0 e ( and ( river:t $0 ) ( loc:t $0 s0 ) ) )
what river flow through s0	( lambda $0 e ( and ( river:t $0 ) ( loc:t $0 s0 ) ) )
what river stream through the most state	( argmax $0 ( river:t $0 ) ( count $1 ( and ( state:t $1 ) ( loc:t $0 $1 ) ) ) )
which river went through the most state	( argmax $0 ( river:t $0 ) ( count $1 ( and ( state:t $1 ) ( loc:t $0 $1 ) ) ) )
what river flow through the most state	( argmax $0 ( river:t $0 ) ( count $1 ( and ( state:t $1 ) ( loc:t $0 $1 ) ) ) )
which river travers most state	( argmax $0 ( river:t $0 ) ( count $1 ( and ( state:t $1 ) ( loc:t $0 $1 ) ) ) )
which river pass through most state	( argmax $0 ( river:t $0 ) ( count $1 ( and ( state:t $1 ) ( loc:t $0 $1 ) ) ) )
which river come through the most state	( argmax $0 ( river:t $0 ) ( count $1 ( and ( state:t $1 ) ( loc:t $0 $1 ) ) ) )
what river pass through the most state	( argmax $0 ( river:t $0 ) ( count $1 ( and ( state:t $1 ) ( loc:t $0 $1 ) ) ) )
what stream are in s0	( lambda $0 e ( and ( river:t $0 ) ( loc:t $0 s0 ) ) )
what are all the river in s0	( lambda $0 e ( and ( river:t $0 ) ( loc:t $0 s0 ) ) )
what river are they in s0	( lambda $0 e ( and ( river:t $0 ) ( loc:t $0 s0 ) ) )
what waterway are in s0	( lambda $0 e ( and ( river:t $0 ) ( loc:t $0 s0 ) ) )
what counti is c0 in	( lambda $0 e ( and ( state:t $0 ) ( loc:t c0 $0 ) ) )
what state is c0 in	( lambda $0 e ( and ( state:t $0 ) ( loc:t c0 $0 ) ) )
how high is the highest center of s0	( elevation:i ( argmax $0 ( and ( place:t $0 ) ( loc:t $0 s0 ) ) ( elevation:i $0 ) ) )
how high is the highest point of s0	( elevation:i ( argmax $0 ( and ( place:t $0 ) ( loc:t $0 s0 ) ) ( elevation:i $0 ) ) )
how mani river doe s0 have	( count $0 ( and ( river:t $0 ) ( loc:t $0 s0 ) ) )
how mani river doe s0 have	( count $0 ( and ( river:t $0 ) ( loc:t $0 s0 ) ) )
which state has the most river	( argmax $0 ( state:t $0 ) ( count $1 ( and ( river:t $1 ) ( loc:t $1 $0 ) ) ) )
what is the capit of s0	( capital:c s0 )
what is the capit of the state with the most dweller	( capital:c ( argmax $1 ( state:t $1 ) ( population:i $1 ) ) )
what is the capit of the state with the largest popul	( capital:c ( argmax $1 ( state:t $1 ) ( population:i $1 ) ) )
which state has the most major river	( argmax $0 ( state:t $0 ) ( count $1 ( and ( major:t $1 ) ( river:t $1 ) ( loc:t $1 $0 ) ) ) )
what is the princip of s0	( capital:c s0 )
which state has the lowest altitud	( argmin $0 ( state:t $0 ) ( elevation:i $0 ) )
what is the populac of c0	( population:i c0 )
number of state border s0	( count $0 ( and ( state:t $0 ) ( next_to:t $0 s0 ) ) )
how mani state border s0	( count $0 ( and ( state:t $0 ) ( next_to:t $0 s0 ) ) )
how mani state border s0	( count $0 ( and ( state:t $0 ) ( next_to:t $0 s0 ) ) )
which state doe the r0 run through	( lambda $0 e ( and ( state:t $0 ) ( loc:t r0 $0 ) ) )
how mani peopl live in c0	( population:i c0 )
how mani peopl live in c0	( population:i c0 )
how mani state do not have river	( count $0 ( and ( state:t $0 ) ( not ( exists $1 ( and ( river:t $1 ) ( loc:t $1 $0 ) ) ) ) ) )
what state border state that border s0	( lambda $0 e ( and ( state:t $0 ) ( exists $1 ( and ( state:t $1 ) ( next_to:t $1 s0 ) ( next_to:t $0 $1 ) ) ) ) )
what are the major citi in the co0	( lambda $0 e ( and ( major:t $0 ) ( city:t $0 ) ( loc:t $0 co0 ) ) )
what are the major citi in the co0	( lambda $0 e ( and ( major:t $0 ) ( city:t $0 ) ( loc:t $0 co0 ) ) )
what is the most popul metropoli	( argmax $0 ( city:t $0 ) ( population:i $0 ) )
what citi has the most peopl	( argmax $0 ( city:t $0 ) ( population:i $0 ) )
what is the greatest popul citi	( argmax $0 ( city:t $0 ) ( population:i $0 ) )
what is the length of the longest river that pass through s0	( len:i ( argmax $0 ( and ( river:t $0 ) ( loc:t $0 s0 ) ) ( len:i $0 ) ) )
how highest is m0	( elevation:i m0 )
how high is mt mckinley	( elevation:i m0 )
how -er is m0	( elevation:i m0 )
take me the number of river in s0	( count $0 ( and ( river:t $0 ) ( loc:t $0 s0 ) ) )
give me the number of river in s0	( count $0 ( and ( river:t $0 ) ( loc:t $0 s0 ) ) )
what is the largest river in s0 state	( argmax $0 ( and ( river:t $0 ) ( loc:t $0 s0 ) ) ( size:i $0 ) )
what is the capit of the s0 nation	( capital:c s0 )
what is the capit of the s0 citi	( capital:c s0 )
what is the lowest point in the state of s0	( argmin $0 ( and ( place:t $0 ) ( loc:t $0 s0 ) ) ( elevation:i $0 ) )
what are the major citi in s0	( lambda $0 e ( and ( major:t $0 ) ( city:t $0 ) ( loc:t $0 s0 ) ) )
what are the main citi in s0	( lambda $0 e ( and ( major:t $0 ) ( city:t $0 ) ( loc:t $0 s0 ) ) )
what is the combin area of all 50 state	( sum $0 ( state:t $0 ) ( area:i $0 ) )
what is the lowest point in s0 in meter	( argmin $0 ( and ( place:t $0 ) ( loc:t $0 s0 ) ) ( elevation:i $0 ) )
what state border s0	( lambda $0 e ( and ( state:t $0 ) ( next_to:t $0 s0 ) ) )
what are the major citi in the citi of s0	( lambda $0 e ( and ( major:t $0 ) ( city:t $0 ) ( loc:t $0 s0 ) ) )
what are the major citi in the co0 of s0	( lambda $0 e ( and ( major:t $0 ) ( city:t $0 ) ( loc:t $0 s0 ) ) )
what is the highest point in the state border s0	( argmax $0 ( and ( place:t $0 ) ( exists $1 ( and ( state:t $1 ) ( next_to:t $1 s0 ) ( loc:t $0 $1 ) ) ) ) ( elevation:i $0 ) )
where is the highest object in s0	( lambda $0 e ( loc:t ( argmax $1 ( and ( place:t $1 ) ( loc:t $1 s0 ) ) ( elevation:i $1 ) ) $0 ) )
what is the highest tip in s0	( argmax $0 ( and ( place:t $0 ) ( loc:t $0 s0 ) ) ( elevation:i $0 ) )
which state capit has the smallest popul	( argmin $0 ( capital:t $0 ) ( population:i $0 ) )
which state capit has the smallest popul	( argmin $0 ( capital:t $0 ) ( population:i $0 ) )
which counti border s0	( lambda $0 e ( and ( state:t $0 ) ( next_to:t $0 s0 ) ) )
how larger is s0	( size:i s0 )
what is the smallest state border s0	( argmin $0 ( and ( state:t $0 ) ( next_to:t $0 s0 ) ) ( size:i $0 ) )
what is the smallest state surround s0	( argmin $0 ( and ( state:t $0 ) ( next_to:t $0 s0 ) ) ( size:i $0 ) )
which state has the highest popul densiti	( argmax $0 ( state:t $0 ) ( density:i $0 ) )
which of the state border s0 has the largest popul	( argmax $0 ( and ( state:t $0 ) ( next_to:t $0 s0 ) ) ( population:i $0 ) )
which of the state surround s0 has the largest popul	( argmax $0 ( and ( state:t $0 ) ( next_to:t $0 s0 ) ) ( population:i $0 ) )
which of the state border s0 has the largest popul	( argmax $0 ( and ( state:t $0 ) ( next_to:t $0 s0 ) ) ( population:i $0 ) )
what state border s0	( lambda $0 e ( and ( state:t $0 ) ( next_to:t $0 s0 ) ) )
how mani person live in the co0	( population:i co0 )
what is the popul of the state with the highest popul figur	( population:i ( argmax $0 ( state:t $0 ) ( density:i $0 ) ) )
what is the popul of the state with the highest popul mass	( population:i ( argmax $0 ( state:t $0 ) ( density:i $0 ) ) )
what state have citi n0	( lambda $0 e ( and ( state:t $0 ) ( exists $1 ( and ( city:t $1 ) ( named:t $1 n0 ) ( loc:t $1 $0 ) ) ) ) )
what state have citi n0	( lambda $0 e ( and ( state:t $0 ) ( exists $1 ( and ( city:t $1 ) ( named:t $1 n0 ) ( loc:t $1 $0 ) ) ) ) )
what is the popul of the state that border the most statess	( population:i ( argmax $0 ( state:t $0 ) ( count $1 ( and ( state:t $1 ) ( next_to:t $0 $1 ) ) ) ) )
how mani state border the state with the largest populac	( count $0 ( and ( state:t $0 ) ( next_to:t $0 ( argmax $1 ( state:t $1 ) ( population:i $1 ) ) ) ) )
what is the state with the largest area	( argmax $0 ( state:t $0 ) ( area:i $0 ) )
what state has the largest area	( argmax $0 ( state:t $0 ) ( area:i $0 ) )
what state has the largest area	( argmax $0 ( state:t $0 ) ( area:i $0 ) )
how long is the r0 stream	( len:i r0 )
what is the capit of the smallest state	( capital:c ( argmin $1 ( state:t $1 ) ( size:i $1 ) ) )
what is the populac of s0	( population:i s0 )
what is the popul of s0	( population:i s0 )
which state have citi titl c0	( lambda $0 e ( and ( state:t $0 ) ( exists $1 ( and ( city:t $1 ) ( named:t $1 n0 ) ( loc:t $1 $0 ) ) ) ) )
how mani river are in the nation that has the most river	( count $0 ( and ( river:t $0 ) ( loc:t $0 ( argmax $1 ( state:t $1 ) ( count $2 ( and ( river:t $2 ) ( loc:t $2 $1 ) ) ) ) ) ) )
how mani river are in the state that has the most river	( count $0 ( and ( river:t $0 ) ( loc:t $0 ( argmax $1 ( state:t $1 ) ( count $2 ( and ( river:t $2 ) ( loc:t $2 $1 ) ) ) ) ) ) )
what is the popul mass of s0	( density:i s0 )
what state doe the r0 pass through	( lambda $0 e ( and ( state:t $0 ) ( loc:t r0 $0 ) ) )
what is the popul of s0	( population:i s0 )
what is the populac of s0	( population:i s0 )
what river are in state that border s0	( lambda $0 e ( and ( river:t $0 ) ( exists $1 ( and ( state:t $1 ) ( next_to:t $1 s0 ) ( loc:t $0 $1 ) ) ) ) )
which state border the r0 stream	( lambda $0 e ( and ( state:t $0 ) ( next_to:t $0 r0 ) ) )
what is the highest point in s0	( argmax $0 ( and ( place:t $0 ) ( loc:t $0 s0 ) ) ( elevation:i $0 ) )
what is the highest object in s0	( argmax $0 ( and ( place:t $0 ) ( loc:t $0 s0 ) ) ( elevation:i $0 ) )
what is the lowest point in s0	( argmin $0 ( and ( place:t $0 ) ( loc:t $0 s0 ) ) ( elevation:i $0 ) )
what is the lowest point in s0	( argmin $0 ( and ( place:t $0 ) ( loc:t $0 s0 ) ) ( elevation:i $0 ) )
what is the lowest point of all state through which the r0 run through	( argmin $0 ( and ( place:t $0 ) ( exists $1 ( and ( state:t $1 ) ( loc:t r0 $1 ) ( loc:t $0 $1 ) ) ) ) ( elevation:i $0 ) )
what is the lowest point of all state through which the r0 pass through	( argmin $0 ( and ( place:t $0 ) ( exists $1 ( and ( state:t $1 ) ( loc:t r0 $1 ) ( loc:t $0 $1 ) ) ) ) ( elevation:i $0 ) )
what is the largest citi in s0	( argmax $0 ( and ( city:t $0 ) ( loc:t $0 s0 ) ) ( size:i $0 ) )
what is the longest river in s0	( argmax $0 ( and ( river:t $0 ) ( loc:t $0 s0 ) ) ( len:i $0 ) )
what is the popul of c0	( population:i c0 )
what is the largest citi in the smallest state in the co0	( argmax $0 ( and ( city:t $0 ) ( loc:t $0 ( argmin $1 ( and ( state:t $1 ) ( loc:t $1 co0 ) ) ( size:i $1 ) ) ) ) ( size:i $0 ) )
what is the popul of s0	( population:i s0 )
what is the highest point in s0 in metr	( argmax $0 ( and ( place:t $0 ) ( loc:t $0 s0 ) ) ( elevation:i $0 ) )
what major citi are situat in s0	( lambda $0 e ( and ( major:t $0 ) ( city:t $0 ) ( loc:t $0 s0 ) ) )
what state border the most state	( argmax $0 ( state:t $0 ) ( count $1 ( and ( state:t $1 ) ( next_to:t $0 $1 ) ) ) )
what state border the most statess	( argmax $0 ( state:t $0 ) ( count $1 ( and ( state:t $1 ) ( next_to:t $0 $1 ) ) ) )
which state border the most state	( argmax $0 ( state:t $0 ) ( count $1 ( and ( state:t $1 ) ( next_to:t $0 $1 ) ) ) )
how mani popul doe s0 have	( population:i s0 )
how mani peopl live in s0	( population:i s0 )
what are the big citi in s0	( lambda $0 e ( and ( major:t $0 ) ( city:t $0 ) ( loc:t $0 s0 ) ) )
what is the highest mountain in co0	( argmax $0 ( and ( mountain:t $0 ) ( loc:t $0 co0 ) ) ( elevation:i $0 ) )
what is the highest hill in the co0	( argmax $0 ( and ( mountain:t $0 ) ( loc:t $0 co0 ) ) ( elevation:i $0 ) )
what state contain the highest point of those the r0 river travers	( lambda $0 e ( and ( state:t $0 ) ( loc:t ( argmax $1 ( and ( place:t $1 ) ( loc:t r0 $1 ) ) ( elevation:i $1 ) ) $0 ) ) )
where is the highest mountain of the unit state	( lambda $0 e ( loc:t ( argmax $1 ( and ( mountain:t $1 ) ( loc:t $1 co0 ) ) ( elevation:i $1 ) ) $0 ) )
how high is the highest point in co0	( elevation:i ( argmax $0 ( and ( place:t $0 ) ( loc:t $0 co0 ) ) ( elevation:i $0 ) ) )
what is the dens of the s0	( density:i s0 )
what is the mass of the s0	( density:i s0 )
what is the highest altitud of c0	( argmax $0 ( and ( place:t $0 ) ( loc:t $0 c0 ) ) ( elevation:i $0 ) )
how mani capit doe rhode island have	( count $0 ( and ( capital:t $0 ) ( loc:t $0 s0 ) ) )
how long is the r0 waterway	( len:i r0 )
how long is the longest river in s0	( len:i ( argmax $0 ( and ( river:t $0 ) ( loc:t $0 s0 ) ) ( len:i $0 ) ) )
how long is the longest stream in s0	( len:i ( argmax $0 ( and ( river:t $0 ) ( loc:t $0 s0 ) ) ( len:i $0 ) ) )
what is the state with the smallest area	( argmin $0 ( state:t $0 ) ( area:i $0 ) )
what is the state with the smallest area	( argmin $0 ( state:t $0 ) ( area:i $0 ) )
which river do not pass through s0	( lambda $0 e ( and ( river:t $0 ) ( not ( loc:t $0 s0 ) ) ) )
what is the lowest point in co0	( argmin $0 ( and ( place:t $0 ) ( loc:t $0 co0 ) ) ( elevation:i $0 ) )
what is the lowest object in co0	( argmin $0 ( and ( place:t $0 ) ( loc:t $0 co0 ) ) ( elevation:i $0 ) )
what is the popul of c0	( population:i c0 )
what is the populac of c0	( population:i c0 )
what is the highest point in s0	( argmax $0 ( and ( place:t $0 ) ( loc:t $0 s0 ) ) ( elevation:i $0 ) )
what is the highest point in s0	( argmax $0 ( and ( place:t $0 ) ( loc:t $0 s0 ) ) ( elevation:i $0 ) )
how mani peopl live in c0	( population:i c0 )
how mani person live in c0	( population:i c0 )
which river do not run through co0	( lambda $0 e ( and ( river:t $0 ) ( not ( loc:t $0 co0 ) ) ) )
which river do not pass through co0	( lambda $0 e ( and ( river:t $0 ) ( not ( loc:t $0 co0 ) ) ) )
name all the river in s0	( lambda $0 e ( and ( river:t $0 ) ( loc:t $0 s0 ) ) )
identifi all the river in s0	( lambda $0 e ( and ( river:t $0 ) ( loc:t $0 s0 ) ) )
what is the longest river in the biggest state	( argmax $0 ( and ( river:t $0 ) ( loc:t $0 ( argmax $1 ( state:t $1 ) ( size:i $1 ) ) ) ) ( len:i $0 ) )
what is the longest river in the big state	( argmax $0 ( and ( river:t $0 ) ( loc:t $0 ( argmax $1 ( state:t $1 ) ( size:i $1 ) ) ) ) ( len:i $0 ) )
what is capit of the state with the lowest point	( capital:c ( the $1 ( and ( loc:t ( argmin $2 ( place:t $2 ) ( elevation:i $2 ) ) $1 ) ( state:t $1 ) ) ) )
what is capit of the state with the lowest tip	( capital:c ( the $1 ( and ( loc:t ( argmin $2 ( place:t $2 ) ( elevation:i $2 ) ) $1 ) ( state:t $1 ) ) ) )
how long is the longest river in the co0	( len:i ( argmax $0 ( and ( river:t $0 ) ( loc:t $0 co0 ) ) ( len:i $0 ) ) )
what is the area of s0	( area:i s0 )
what is the district of s0	( area:i s0 )
what are the major town in s0	( lambda $0 e ( and ( major:t $0 ) ( city:t $0 ) ( loc:t $0 s0 ) ) )
what state has the smallest urban popul	( argmin $0 ( state:t $0 ) ( population:i $0 ) )
what is the popul densiti of the largest state	( density:i ( argmax $0 ( state:t $0 ) ( size:i $0 ) ) )
which state is m0 in	( lambda $0 e ( and ( state:t $0 ) ( loc:t m0 $0 ) ) )
what is the highest height in s0	( argmax $0 ( and ( place:t $0 ) ( loc:t $0 s0 ) ) ( elevation:i $0 ) )
which term border s0	( lambda $0 e ( and ( state:t $0 ) ( next_to:t $0 s0 ) ) )
which state border s0	( lambda $0 e ( and ( state:t $0 ) ( next_to:t $0 s0 ) ) )
how mani person live in s0	( population:i s0 )
how mani peopl live in s0	( population:i s0 )
get me what citi are in s0	( lambda $0 e ( and ( city:t $0 ) ( loc:t $0 s0 ) ) )
tell me what citi are in s0	( lambda $0 e ( and ( city:t $0 ) ( loc:t $0 s0 ) ) )
what river pass through the state with the most citi	( lambda $0 e ( and ( river:t $0 ) ( loc:t $0 ( argmax $1 ( state:t $1 ) ( count $2 ( and ( city:t $2 ) ( loc:t $2 $1 ) ) ) ) ) ) )
what state border s0	( lambda $0 e ( and ( state:t $0 ) ( next_to:t $0 s0 ) ) )
what is the largest state border s0	( argmax $0 ( and ( state:t $0 ) ( next_to:t $0 s0 ) ) ( size:i $0 ) )
what is the largest state surround s0	( argmax $0 ( and ( state:t $0 ) ( next_to:t $0 s0 ) ) ( size:i $0 ) )
what state surround s0 has the largest popul	( argmax $0 ( and ( state:t $0 ) ( next_to:t $0 s0 ) ) ( population:i $0 ) )
what state border s0 has the largest popul	( argmax $0 ( and ( state:t $0 ) ( next_to:t $0 s0 ) ) ( population:i $0 ) )
what state border s0 has the largest popul	( argmax $0 ( and ( state:t $0 ) ( next_to:t $0 s0 ) ) ( population:i $0 ) )
what are the demograph of the major citi of s0	( lambda $0 e ( exists $1 ( and ( city:t $1 ) ( major:t $1 ) ( loc:t $1 s0 ) ( population:t $1 $0 ) ) ) )
what are the popul of the major citi of s0	( lambda $0 e ( exists $1 ( and ( city:t $1 ) ( major:t $1 ) ( loc:t $1 s0 ) ( population:t $1 $0 ) ) ) )
what are the popul of the main citi of s0	( lambda $0 e ( exists $1 ( and ( city:t $1 ) ( major:t $1 ) ( loc:t $1 s0 ) ( population:t $1 $0 ) ) ) )
how mani person live in s0	( population:i s0 )
what are the popul of s0	( population:i s0 )
how mani peopl live in s0	( population:i s0 )
what are the populac of s0	( population:i s0 )
what is the largest citi in smallest state through which the r0 run	( argmax $0 ( and ( city:t $0 ) ( loc:t $0 ( argmin $1 ( and ( state:t $1 ) ( loc:t r0 $1 ) ) ( size:i $1 ) ) ) ) ( size:i $0 ) )
what is the largest citi in smallest state through which the r0 run	( argmax $0 ( and ( city:t $0 ) ( loc:t $0 ( argmin $1 ( and ( state:t $1 ) ( loc:t r0 $1 ) ) ( size:i $1 ) ) ) ) ( size:i $0 ) )
what is the largest citi in smallest state through which the r0 pass	( argmax $0 ( and ( city:t $0 ) ( loc:t $0 ( argmin $1 ( and ( state:t $1 ) ( loc:t r0 $1 ) ) ( size:i $1 ) ) ) ) ( size:i $0 ) )
what state have citi n0	( lambda $0 e ( and ( state:t $0 ) ( exists $1 ( and ( city:t $1 ) ( named:t $1 n0 ) ( loc:t $1 $0 ) ) ) ) )
how highest is the highest point in s0	( elevation:i ( argmax $0 ( and ( place:t $0 ) ( loc:t $0 s0 ) ) ( elevation:i $0 ) ) )
what is the smallest state that the r0 flow through	( argmin $0 ( and ( state:t $0 ) ( loc:t r0 $0 ) ) ( size:i $0 ) )
what is the smallest state that the r0 feed through	( argmin $0 ( and ( state:t $0 ) ( loc:t r0 $0 ) ) ( size:i $0 ) )
what is the smallest state that the r0 pass through	( argmin $0 ( and ( state:t $0 ) ( loc:t r0 $0 ) ) ( size:i $0 ) )
what is the area of the s0	( area:i s0 )
what is the area of the s0 state	( area:i s0 )
where is the r0 creek	( lambda $0 e ( loc:t r0 $0 ) )
what is the lowest tip in s0	( argmin $0 ( and ( place:t $0 ) ( loc:t $0 s0 ) ) ( elevation:i $0 ) )
what is the lowest point in s0	( argmin $0 ( and ( place:t $0 ) ( loc:t $0 s0 ) ) ( elevation:i $0 ) )
what is the area of s0	( area:i s0 )
how big is texan	( size:i s0 )
how huge is s0	( size:i s0 )
how larger is s0	( size:i s0 )
