what vacanc are avail	( answer ( job ANS ) )
do you want to list job use languageid0	( answer ( job ANS ) ( language ANS languageid0 ) )
what kind of work can i find for an old languageid0 titleid0	( answer ( job ANS ) ( language ANS languageid0 ) ( title ANS titleid0 ) )
what kind of work does areaid0 have	( answer ( job ANS ) ( area ANS areaid0 ) )
what job can a platformid0 titleid0 use	( answer ( job ANS ) ( platform ANS platformid0 ) ( title ANS titleid0 ) )
what job do you need year0 year of experience at companyid0	( answer ( job ANS ) ( req_exp ANS year0 ) ( company ANS companyid0 ) )
plea tell me the job to use languageid0 which does not require windows.	( answer ( job ANS ) ( language ANS languageid0 ) ( \+ ( platform ANS platformid0 ) ) )
would you like to list your job use languageid0	( answer ( job ANS ) ( language ANS languageid0 ) )
tell me your job use languageid0	( answer ( job ANS ) ( language ANS languageid0 ) )
would you show me a job to work in the platformid0	( answer ( job ANS ) ( platform ANS platformid0 ) )
show me a job at companyid0 earn num_salary	( answer ( job ANS ) ( company ANS companyid0 ) ( salary_greater_than ANS num_salary year ) )
can you give me an areaid0 specialist job	( answer ( job ANS ) ( area ANS areaid0 ) )
which job do not require a diploma but use languageid0	( answer ( job ANS ) ( \+ ( req_deg ANS ) ) ( language ANS languageid0 ) )
list job that require year0 year of experience with languageid0 a degid0	( answer ( job ANS ) ( language ANS languageid0 ) ( req_deg ANS degid0 ) ( req_exp ANS year0 ) )
do you give some work in the solar system locid0	( answer ( job ANS ) ( loc ANS locid0 ) ( platform ANS platformid0 ) )
does locid0 have a job	( answer ( job ANS ) ( loc ANS locid0 ) )
which job in locid0 need languageid0 and platformid0	( answer ( job ANS ) ( loc ANS locid0 ) ( language ANS languageid0 ) ( platform ANS platformid0 ) )
what job use languageid0 ++ with a salary of num_salary	( answer ( job ANS ) ( language ANS languageid0 ) ( salary_greater_than ANS num_salary year ) )
what num_salary job are in locid0 that require degid0	( answer ( job ANS ) ( salary_greater_than ANS num_salary year ) ( loc ANS locid0 ) ( req_deg ANS degid0 ) )
is there a job for areaid0	( answer ( job ANS ) ( area ANS areaid0 ) )
plea tell me what kind of work you have	( answer ( job ANS ) )
would you like to list the job on platformid0	( answer ( job ANS ) ( platform ANS platformid0 ) )
are there job in languageid0 ++ with a salary of num_salary	( answer ( job ANS ) ( language ANS languageid0 ) ( salary_greater_than ANS num_salary year ) )
what are your non-microsoft job in locid0	( answer ( job ANS ) ( loc ANS locid0 ) ( \+ ( company ANS companyid0 ) ) )
is there a job with a salary of num_salary	( answer ( job ANS ) ( salary_greater_than ANS num_salary year ) )
plea tell me what work use languageid0 .	( answer ( job ANS ) ( language ANS languageid0 ) )
is there a job in companyid0 that require degid0	( answer ( job ANS ) ( company ANS companyid0 ) ( req_deg ANS degid0 ) )
show me locid0 s languageid0 work for two year experience	( answer ( language ANS languageid0 ) ( job ANS ) ( loc ANS locid0 ) ( des_exp ANS year0 ) )
show me new job in york require degid0	( answer ( loc ANS locid0 ) ( job ANS ) ( req_deg ANS degid0 ) )
what job in locid0 require a baccalaur	( answer ( job ANS ) ( loc ANS locid0 ) ( req_deg ANS degid0 ) )
tell me a job that require degid0	( answer ( job ANS ) ( req_deg ANS degid0 ) )
show job with languageid0	( answer ( job ANS ) ( language ANS languageid0 ) )
what job do we do on platformid0 machin	( answer ( job ANS ) ( area ANS areaid0 ) ( platform ANS platformid0 ) )
show me work that require year0 year of experience in languageid0 ++	( answer ( job ANS ) ( req_exp ANS year0 ) ( language ANS languageid0 ) )
is there a companyid0 job involve languageid0	( answer ( job ANS ) ( company ANS companyid0 ) ( language ANS languageid0 ) )
i need one year of experience, but show me the job i want two year of experience	( answer ( job ANS ) ( req_exp ANS year0 ) ( des_exp ANS year1 ) )
what is the job of a areaid0 specialist	( answer ( job ANS ) ( area ANS areaid0 ) )
what is the job of pay num_salary per year	( answer ( job ANS ) ( salary_greater_than ANS num_salary year ) )
what kind of work do you have with languageid0	( answer ( job ANS ) ( language ANS languageid0 ) )
show all locid0 areaid0 job	( answer ( area ANS areaid0 ) ( job ANS ) ( loc ANS locid0 ) )
is there a job that require degid0 to companyid0 in locid0	( answer ( job ANS ) ( req_deg ANS degid0 ) ( company ANS companyid0 ) ( loc ANS locid0 ) )
what languageid0 job do locid0 s companyid0 have	( answer ( language ANS languageid0 ) ( job ANS ) ( company ANS companyid0 ) ( loc ANS locid0 ) )
which job pay num_salary that don t require a doctor	( answer ( job ANS ) ( salary_greater_than ANS num_salary year ) ( \+ ( req_deg ANS degid0 ) ) )
what kind of work do you have with languageid0	( answer ( job ANS ) ( language ANS languageid0 ) )
show me a job with a salary of num_salary	( answer ( job ANS ) ( salary_greater_than ANS num_salary year ) )
show me the work of a titleid0 that does not require experience in platformid0	( answer ( title ANS titleid0 ) ( job ANS ) ( \+ ( ( req_exp ANS ) ( platform ANS platformid0 ) ) ) )
is there a job that use languageid0	( answer ( job ANS ) ( language ANS languageid0 ) )
what job can languageid0 titleid0 find in locid0 on platformid0	( answer ( job ANS ) ( language ANS languageid0 ) ( title ANS titleid0 ) ( loc ANS locid0 ) ( platform ANS platformid0 ) )
is there a job in companyid0 that require degid0	( answer ( job ANS ) ( company ANS companyid0 ) ( req_deg ANS degid0 ) )
what job do you use languageid0 with over num_salary salary per year	( answer ( job ANS ) ( language ANS languageid0 ) ( salary_greater_than ANS num_salary year ) )
tell u about your work in locid0	( answer ( job ANS ) ( loc ANS locid0 ) )
tell me work in a local area areaid0	( answer ( job ANS ) ( area ANS areaid0 ) )
do you have a job in locid0	( answer ( job ANS ) ( loc ANS locid0 ) )
what are the job in locid0 that pay at least num_salary a year	( answer ( job ANS ) ( loc ANS locid0 ) ( salary_greater_than ANS num_salary year ) )
are there any computer task for platformid0	( answer ( job ANS ) ( platform ANS platformid0 ) )
plea tell me the job that require bscs.	( answer ( job ANS ) ( req_deg ANS degid0 ) )
what job do languageid0 use on platformid0 machin and pay num_salary	( answer ( job ANS ) ( language ANS languageid0 ) ( platform ANS platformid0 ) ( salary_greater_than ANS num_salary year ) )
what can i find use languageid0 on platformid0	( answer ( job ANS ) ( language ANS languageid0 ) ( platform ANS platformid0 ) )
what kind of work does a languageid0 titleid0 who doesn t know languageid1 have	( answer ( job ANS ) ( language ANS languageid0 ) ( \+ ( language ANS languageid1 ) ) )
what companyid0 position require a bsc	( answer ( job ANS ) ( company ANS companyid0 ) ( req_deg ANS degid0 ) )
what is the job of an areaid0 specialist	( answer ( job ANS ) ( area ANS areaid0 ) )
what kind of work does locid0 need only degid0 and ha no experience	( answer ( job ANS ) ( loc ANS locid0 ) ( req_deg ANS degid0 ) ( \+ ( req_exp ANS ) ) )
would you like to view the job on your platformid0	( answer ( job ANS ) ( platform ANS platformid0 ) )
what is more than num_salary job a year that require degid0	( answer ( job ANS ) ( req_deg ANS degid0 ) ( salary_greater_than ANS num_salary year ) )
would you like to list the vm job	( answer ( job ANS ) ( platform ANS platformid0 ) )
do you want to list job in locid0	( answer ( job ANS ) ( loc ANS locid0 ) )
which position at companyid0 require a degid0 to get a job	( answer ( job ANS ) ( company ANS companyid0 ) ( req_deg ANS degid0 ) )
show me a job wish mom in locid0 with companyid0	( answer ( job ANS ) ( des_deg ANS degid0 ) ( loc ANS locid0 ) ( company ANS companyid0 ) )
job pay num_salary	( answer ( job ANS ) ( salary_greater_than ANS num_salary year ) )
id want to see a job in locid0 for a prologu titleid0 who prefer at least num_salary areaid0 a year	( answer ( job ANS ) ( loc ANS locid0 ) ( language ANS languageid0 ) ( title ANS titleid0 ) ( salary_greater_than ANS num_salary year ) ( area ANS areaid0 ) )
what are the avail job	( answer ( job ANS ) )
in locid0 , give me job	( answer ( job ANS ) ( loc ANS locid0 ) )
use languageid0 , give me the job	( answer ( job ANS ) ( language ANS languageid0 ) )
on the platformid0 , show me the job	( answer ( job ANS ) ( platform ANS platformid0 ) )
what need a degree is location in locid0 and what job pay num_salary	( answer ( job ANS ) ( salary_greater_than ANS num_salary year ) ( loc ANS locid0 ) ( req_deg ANS ) )
how about companyid0 , what job are you do	( answer ( job ANS ) ( platform ANS platformid0 ) )
a areaid0 specialist job , give me job	( answer ( job ANS ) ( area ANS areaid0 ) )
what dont require a degree but use languageid0 are , what job	( answer ( job ANS ) ( \+ ( req_deg ANS ) ) ( language ANS languageid0 ) )
in locid0 on the platformid0 system , give some job	( answer ( job ANS ) ( loc ANS locid0 ) ( platform ANS platformid0 ) )
any job with companyid0 is there	( answer ( job ANS ) ( company ANS companyid0 ) )
any job with companyid0 is there	( answer ( job ANS ) ( company ANS companyid0 ) )
on platformid0 , list job	( answer ( job ANS ) ( platform ANS platformid0 ) )
platformid0 give me the job	( answer ( job ANS ) ( platform ANS platformid0 ) )
locid0 s experience require at least year0 year of job	( answer ( job ANS ) ( loc ANS locid0 ) ( req_exp ANS year0 ) )
require degid0 , tell me job	( answer ( job ANS ) ( req_deg ANS degid0 ) )
in the languageid0 of platformid0 , give me job	( answer ( job ANS ) ( platform ANS platformid0 ) ( language ANS languageid0 ) )
in areaid0 s platformid0 , tell me .	( answer ( job ANS ) ( platform ANS platformid0 ) ( area ANS areaid0 ) )
about the areaid0 , what kind of job	( answer ( job ANS ) ( platform ANS platformid0 ) ( area ANS areaid0 ) )
use languageid0 , show the job	( answer ( job ANS ) ( language ANS languageid0 ) )
are there do the areaid0 machin silicon for computer areaid0 , what job	( answer ( job ANS ) ( area ANS areaid0 ) ( platform ANS platformid0 ) )
are require degid0 locid0 there , what job	( answer ( job ANS ) ( loc ANS locid0 ) ( req_deg ANS degid0 ) )
for $ num_salary , show me the areaid0 job in locid0	( answer ( area ANS areaid0 ) ( job ANS ) ( loc ANS locid0 ) ( salary_greater_than ANS num_salary year ) )
show me the job greater than num_salary per year use languageid0	( answer ( job ANS ) ( language ANS languageid0 ) ( salary_greater_than ANS num_salary year ) )
in locid0 , tell me about job	( answer ( job ANS ) ( loc ANS locid0 ) )
the job in areaid0 , tell me .	( answer ( job ANS ) ( area ANS areaid0 ) )
the job in locid0 , give me	( answer ( job ANS ) ( loc ANS locid0 ) )
is there a pay at least 100 num_salary per year in locid0	( answer ( job ANS ) ( loc ANS locid0 ) ( salary_greater_than ANS num_salary year ) )
for the platformid0 , are there any computer job	( answer ( job ANS ) ( platform ANS platformid0 ) )
on platformid0 , what is the use of languageid0	( answer ( job ANS ) ( language ANS languageid0 ) ( platform ANS platformid0 ) )
require degid0 , tell me job	( answer ( job ANS ) ( req_deg ANS degid0 ) )
for a areaid0 specialist , tell me job	( answer ( job ANS ) ( area ANS areaid0 ) )
locid0 , list job	( answer ( job ANS ) ( loc ANS locid0 ) )
out there , what is it	( answer ( job ANS ) )
on platformid0 , show the job	( answer ( job ANS ) ( platform ANS platformid0 ) )
