use languageid0 ? list job	( answer ( job ANS ) ( language ANS languageid0 ) )
use languageid0 , give me the job	( answer ( job ANS ) ( language ANS languageid0 ) )
which use applicationid0 show me the job	( answer ( job ANS ) ( application ANS applicationid0 ) )
which use applicationid0 show me the job	( answer ( job ANS ) ( application ANS applicationid0 ) )
at companyid0 earn num_salary , show me job	( answer ( job ANS ) ( company ANS companyid0 ) ( salary_greater_than ANS num_salary year ) )
at della earn num_salary , show me job	( answer ( job ANS ) ( company ANS companyid0 ) ( salary_greater_than ANS num_salary year ) )
which use applicationid0 show me the job	( answer ( job ANS ) ( application ANS applicationid0 ) )
which use applicationid0 show me the job	( answer ( job ANS ) ( application ANS applicationid0 ) )
any job in locid0 is there	( answer ( job ANS ) ( loc ANS locid0 ) )
any work in locid0 is there	( answer ( job ANS ) ( loc ANS locid0 ) )
the job use languageid0 , give me	( answer ( job ANS ) ( language ANS languageid0 ) )
the job use languageid0 give me	( answer ( job ANS ) ( language ANS languageid0 ) )
in languageid0 , what job are here	( answer ( job ANS ) ( language ANS languageid0 ) )
in languageid0 , what job are	( answer ( job ANS ) ( language ANS languageid0 ) )
use languageid0 , list job	( answer ( job ANS ) ( language ANS languageid0 ) )
use languageid0 for list job	( answer ( job ANS ) ( language ANS languageid0 ) )
a degid0 show me locid0 job	( answer ( loc ANS locid0 ) ( job ANS ) ( req_deg ANS degid0 ) )
the degid0 show me locid0 job	( answer ( loc ANS locid0 ) ( job ANS ) ( req_deg ANS degid0 ) )
are require degid0 locid0 there , what job	( answer ( job ANS ) ( loc ANS locid0 ) ( req_deg ANS degid0 ) )
companyid0 job , are any involve languageid0	( answer ( job ANS ) ( company ANS companyid0 ) ( language ANS languageid0 ) )
companyid0 languageid0 job is there any job	( answer ( job ANS ) ( company ANS companyid0 ) ( language ANS languageid0 ) )
a areaid0 specialist give me the job	( answer ( job ANS ) ( area ANS areaid0 ) )
what are there use languageid0 , job	( answer ( job ANS ) ( language ANS languageid0 ) )
all of qa job in softwar in locid0 show me	( answer ( area ANS areaid0 ) ( job ANS ) ( loc ANS locid0 ) )
any job on platformid0 are there	( answer ( job ANS ) ( platform ANS platformid0 ) )
for a areaid0 specialist , are there any job	( answer ( job ANS ) ( area ANS areaid0 ) )
for a areaid0 specialist , do you have any job	( answer ( job ANS ) ( area ANS areaid0 ) )
in areaid0 program , show me position	( answer ( job ANS ) ( area ANS areaid0 ) )
on areaid0 program , show me position	( answer ( job ANS ) ( area ANS areaid0 ) )
languageid0 use what job are they	( answer ( job ANS ) ( language ANS languageid0 ) )
in locid0 , give me job	( answer ( job ANS ) ( loc ANS locid0 ) )
use languageid0 , give me the job	( answer ( job ANS ) ( language ANS languageid0 ) )
on the platformid0 , show me the job	( answer ( job ANS ) ( platform ANS platformid0 ) )
what need a degree is location in locid0 and what job pay num_salary	( answer ( job ANS ) ( salary_greater_than ANS num_salary year ) ( loc ANS locid0 ) ( req_deg ANS ) )
how about companyid0 , what job are you do	( answer ( job ANS ) ( platform ANS platformid0 ) )
areaid0 specialist job , give me job	( answer ( job ANS ) ( area ANS areaid0 ) )
a areaid0 specialist job , give me job	( answer ( job ANS ) ( area ANS areaid0 ) )
what dont require a degree but use languageid0 are , what job	( answer ( job ANS ) ( \+ ( req_deg ANS ) ) ( language ANS languageid0 ) )
require languageid0 degid0 year0 year experience list of job	( answer ( job ANS ) ( language ANS languageid0 ) ( req_deg ANS degid0 ) ( req_exp ANS year0 ) )
in locid0 on the platformid0 system , give some job	( answer ( job ANS ) ( loc ANS locid0 ) ( platform ANS platformid0 ) )
any job with companyid0 is there	( answer ( job ANS ) ( company ANS companyid0 ) )
any job with companyid0 is there	( answer ( job ANS ) ( company ANS companyid0 ) )
on platformid0 , list job	( answer ( job ANS ) ( platform ANS platformid0 ) )
platformid0 give me the job	( answer ( job ANS ) ( platform ANS platformid0 ) )
a num_salary salary is there any job	( answer ( job ANS ) ( salary_greater_than ANS num_salary year ) )
locid0 s experience require at least year0 year of job	( answer ( job ANS ) ( loc ANS locid0 ) ( req_exp ANS year0 ) )
what s a degid0 job in locid0	( answer ( job ANS ) ( loc ANS locid0 ) ( req_deg ANS degid0 ) )
require degid0 , tell me job	( answer ( job ANS ) ( req_deg ANS degid0 ) )
require degid0 , tell me job	( answer ( job ANS ) ( req_deg ANS degid0 ) )
in the languageid0 of platformid0 , give me job	( answer ( job ANS ) ( platform ANS platformid0 ) ( language ANS languageid0 ) )
in areaid0 s platformid0 , tell me .	( answer ( job ANS ) ( platform ANS platformid0 ) ( area ANS areaid0 ) )
about the areaid0 , what kind of job	( answer ( job ANS ) ( platform ANS platformid0 ) ( area ANS areaid0 ) )
are there do the areaid0 machin silicon for computer areaid0 , what job	( answer ( job ANS ) ( area ANS areaid0 ) ( platform ANS platformid0 ) )
are require degid0 locid0 there , what job	( answer ( job ANS ) ( loc ANS locid0 ) ( req_deg ANS degid0 ) )
that pay num_salary per year , what are the job	( answer ( job ANS ) ( salary_greater_than ANS num_salary year ) )
for $ num_salary , show me the areaid0 job in locid0	( answer ( area ANS areaid0 ) ( job ANS ) ( loc ANS locid0 ) ( salary_greater_than ANS num_salary year ) )
show me the job greater than num_salary per year use languageid0	( answer ( job ANS ) ( language ANS languageid0 ) ( salary_greater_than ANS num_salary year ) )
in locid0 , tell me about job	( answer ( job ANS ) ( loc ANS locid0 ) )
in locid0 , tell me job	( answer ( job ANS ) ( loc ANS locid0 ) )
the job in areaid0 , tell me .	( answer ( job ANS ) ( area ANS areaid0 ) )
the job in locid0 , give me	( answer ( job ANS ) ( loc ANS locid0 ) )
is there a pay at least 100 num_salary per year in locid0	( answer ( job ANS ) ( loc ANS locid0 ) ( salary_greater_than ANS num_salary year ) )
for the platformid0 , are there any computer job	( answer ( job ANS ) ( platform ANS platformid0 ) )
on platformid0 , what is the use of languageid0	( answer ( job ANS ) ( language ANS languageid0 ) ( platform ANS platformid0 ) )
require degid0 , tell me job	( answer ( job ANS ) ( req_deg ANS degid0 ) )
for a areaid0 specialist , tell me job	( answer ( job ANS ) ( area ANS areaid0 ) )
out there , what is it	( answer ( job ANS ) )
on platformid0 , show the job	( answer ( job ANS ) ( platform ANS platformid0 ) )
