are there any job at are companyid0 that require a degid0	( answer ( job ANS ) ( company ANS companyid0 ) ( req_deg ANS degid0 ) )
what are job are there use languageid0	( answer ( job ANS ) ( language ANS languageid0 ) )
are what job are there in locid0 require a degid0	( answer ( job ANS ) ( loc ANS locid0 ) ( req_deg ANS degid0 ) )
what areaid0 job are there in locid0 that pay that num_salary	( answer ( area ANS areaid0 ) ( job ANS ) ( loc ANS locid0 ) ( salary_greater_than ANS num_salary year ) )
what job use languageid0 on on platformid0 machin and pay num_salary	( answer ( job ANS ) ( language ANS languageid0 ) ( platform ANS platformid0 ) ( salary_greater_than ANS num_salary year ) )
tell for me job for a areaid0 specialist	( answer ( job ANS ) ( area ANS areaid0 ) )
are there are any job for a areaid0 specialist	( answer ( job ANS ) ( area ANS areaid0 ) )
what languageid0 job are there with companyid0 in are locid0	( answer ( language ANS languageid0 ) ( job ANS ) ( company ANS companyid0 ) ( loc ANS locid0 ) )
show me the job require at year0 year of experience at companyid0	( answer ( job ANS ) ( req_exp ANS year0 ) ( company ANS companyid0 ) )
me give me the job for a areaid0 specialist	( answer ( job ANS ) ( area ANS areaid0 ) )
tell me job for a areaid0 for specialist	( answer ( job ANS ) ( area ANS areaid0 ) )
what job use languageid0 and languageid1 are avail in locid0 and pay num_salary a and year	( answer ( job ANS ) ( language ANS languageid0 ) ( language ANS languageid1 ) ( loc ANS locid0 ) ( salary_greater_than ANS num_salary year ) )
on give some job in locid0 on a platformid0 system	( answer ( job ANS ) ( loc ANS locid0 ) ( platform ANS platformid0 ) )
what job are there do computer areaid0 on silicon on areaid0 machin	( answer ( job ANS ) ( area ANS areaid0 ) ( platform ANS platformid0 ) )
give me the job use languageid0 me	( answer ( job ANS ) ( language ANS languageid0 ) )
show me locid0 job require a degid0 me	( answer ( loc ANS locid0 ) ( job ANS ) ( req_deg ANS degid0 ) )
are there any for computer job for the platformid0	( answer ( job ANS ) ( platform ANS platformid0 ) )
give me the job for a areaid0 specialist ? for	( answer ( job ANS ) ( area ANS areaid0 ) )
are there any job in in locid0	( answer ( job ANS ) ( loc ANS locid0 ) )
give me me job in locid0	( answer ( job ANS ) ( loc ANS locid0 ) )
what job can a languageid0 titleid0 find in san in antonio on platformid0	( answer ( job ANS ) ( language ANS languageid0 ) ( title ANS titleid0 ) ( loc ANS locid0 ) ( platform ANS platformid0 ) )
show me me locid0 job desire a degid0	( answer ( loc ANS locid0 ) ( job ANS ) ( des_deg ANS degid0 ) )
what job are there in in locid0 require a degid0	( answer ( job ANS ) ( loc ANS locid0 ) ( req_deg ANS degid0 ) )
give me me the job on platformid0	( answer ( job ANS ) ( platform ANS platformid0 ) )
what job are there that dont require a that degree but use languageid0	( answer ( job ANS ) ( \+ ( req_deg ANS ) ) ( language ANS languageid0 ) )
in give me the job in languageid0	( answer ( job ANS ) ( language ANS languageid0 ) )
what in job are there in areaid0	( answer ( job ANS ) ( area ANS areaid0 ) )
are are there any job use languageid0	( answer ( job ANS ) ( language ANS languageid0 ) )
are there any job at companyid0 that require a degid0 ? are	( answer ( job ANS ) ( company ANS companyid0 ) ( req_deg ANS degid0 ) )
list job on platformid0 on	( answer ( job ANS ) ( platform ANS platformid0 ) )
are are there any job with a salary of num_salary	( answer ( job ANS ) ( salary_greater_than ANS num_salary year ) )
show me me locid0 job require a degid0	( answer ( loc ANS locid0 ) ( job ANS ) ( req_deg ANS degid0 ) )
show me job that require year0 year work experience in languageid0 ? that	( answer ( job ANS ) ( req_exp ANS year0 ) ( language ANS languageid0 ) )
show me the job which use me applicationid0	( answer ( job ANS ) ( application ANS applicationid0 ) )
show me the job with of a salary of num_salary	( answer ( job ANS ) ( salary_greater_than ANS num_salary year ) )
what job are there for a areaid0 specialist ? are	( answer ( job ANS ) ( area ANS areaid0 ) )
what job are there are use languageid0	( answer ( job ANS ) ( language ANS languageid0 ) )
tell me job require degid0 me	( answer ( job ANS ) ( req_deg ANS degid0 ) )
in tell me the job in areaid0	( answer ( job ANS ) ( area ANS areaid0 ) )
can you show me all the job can	( answer ( job ANS ) )
there must be some job out there for a must languageid0 titleid0 that think in platformid0 areaid0	( answer ( job ANS ) ( language ANS languageid0 ) ( title ANS titleid0 ) ( platform ANS platformid0 ) ( area ANS areaid0 ) )
are there any computer job for for the platformid0	( answer ( job ANS ) ( platform ANS platformid0 ) )
give me in the job in languageid0	( answer ( job ANS ) ( language ANS languageid0 ) )
show me the job use languageid0 with salary greater than num_salary than per year	( answer ( job ANS ) ( language ANS languageid0 ) ( salary_greater_than ANS num_salary year ) )
me tell me the job in locid0	( answer ( job ANS ) ( loc ANS locid0 ) )
tell me the job in in locid0	( answer ( job ANS ) ( loc ANS locid0 ) )
are there any is job in languageid0 that the salary is num_salary	( answer ( job ANS ) ( language ANS languageid0 ) ( salary_greater_than ANS num_salary year ) )
list the job require languageid0 a degid0 year0 year experience year0	( answer ( job ANS ) ( language ANS languageid0 ) ( req_deg ANS degid0 ) ( req_exp ANS year0 ) )
give me the job me require degid0	( answer ( job ANS ) ( req_deg ANS degid0 ) )
show me me the job which use applicationid0	( answer ( job ANS ) ( application ANS applicationid0 ) )
are there any job in languageid0 that the salary is num_salary ? that	( answer ( job ANS ) ( language ANS languageid0 ) ( salary_greater_than ANS num_salary year ) )
give me the job use languageid0 that dont require platformid0 me	( answer ( job ANS ) ( language ANS languageid0 ) ( \+ ( platform ANS platformid0 ) ) )
what job are avail are for a platformid0 titleid0	( answer ( job ANS ) ( platform ANS platformid0 ) ( title ANS titleid0 ) )
what job pay num_salary are location in locid0 and in require a degid0	( answer ( job ANS ) ( salary_greater_than ANS num_salary year ) ( loc ANS locid0 ) ( req_deg ANS degid0 ) )
what job pay num_salary are location are in locid0 and require a degree	( answer ( job ANS ) ( salary_greater_than ANS num_salary year ) ( loc ANS locid0 ) ( req_deg ANS ) )
are what are the job that pay num_salary per year	( answer ( job ANS ) ( salary_greater_than ANS num_salary year ) )
give me the me job in languageid0	( answer ( job ANS ) ( language ANS languageid0 ) )
tell me the job use languageid0 ? me	( answer ( job ANS ) ( language ANS languageid0 ) )
what areaid0 job are there in locid0 that in pay num_salary	( answer ( area ANS areaid0 ) ( job ANS ) ( loc ANS locid0 ) ( salary_greater_than ANS num_salary year ) )
per show me the job use languageid0 with salary greater than num_salary per year	( answer ( job ANS ) ( language ANS languageid0 ) ( salary_greater_than ANS num_salary year ) )
in what job pay num_salary are location in locid0 and require a degree	( answer ( job ANS ) ( salary_greater_than ANS num_salary year ) ( loc ANS locid0 ) ( req_deg ANS ) )
show me the languageid0 job in locid0 that desire year0 year experience year0	( answer ( language ANS languageid0 ) ( job ANS ) ( loc ANS locid0 ) ( des_exp ANS year0 ) )
show me the job that require year0 year of experience but desire year1 but year of experience	( answer ( job ANS ) ( req_exp ANS year0 ) ( des_exp ANS year1 ) )
what is out there is	( answer ( job ANS ) )
give me the job in languageid0 in	( answer ( job ANS ) ( language ANS languageid0 ) )
what languageid0 job are there with companyid0 in in locid0	( answer ( language ANS languageid0 ) ( job ANS ) ( company ANS companyid0 ) ( loc ANS locid0 ) )
tell me job require degid0 ? me	( answer ( job ANS ) ( req_deg ANS degid0 ) )
what job are there in locid0 in require a degid0	( answer ( job ANS ) ( loc ANS locid0 ) ( req_deg ANS degid0 ) )
show me the job that require year0 but year of experience but desire year1 year of experience	( answer ( job ANS ) ( req_exp ANS year0 ) ( des_exp ANS year1 ) )
what job in are there in languageid0	( answer ( job ANS ) ( language ANS languageid0 ) )
show me position in areaid0 program ? in	( answer ( job ANS ) ( area ANS areaid0 ) )
tell me job require me degid0	( answer ( job ANS ) ( req_deg ANS degid0 ) )
are there any job in areaid0 are	( answer ( job ANS ) ( area ANS areaid0 ) )
what and job in locid0 require languageid0 and platformid0	( answer ( job ANS ) ( loc ANS locid0 ) ( language ANS languageid0 ) ( platform ANS platformid0 ) )
show me the areaid0 job in locid0 with a in salary of num_salary	( answer ( area ANS areaid0 ) ( job ANS ) ( loc ANS locid0 ) ( salary_greater_than ANS num_salary year ) )
what job use languageid0 and languageid1 are avail and in locid0 and pay num_salary a year	( answer ( job ANS ) ( language ANS languageid0 ) ( language ANS languageid1 ) ( loc ANS locid0 ) ( salary_greater_than ANS num_salary year ) )
what are the job that pay num_salary per year per	( answer ( job ANS ) ( salary_greater_than ANS num_salary year ) )
what job in in locid0 require a degid0	( answer ( job ANS ) ( loc ANS locid0 ) ( req_deg ANS degid0 ) )
are are there any job with companyid0 involve languageid0	( answer ( job ANS ) ( company ANS companyid0 ) ( language ANS languageid0 ) )
are for there any job for a areaid0 specialist	( answer ( job ANS ) ( area ANS areaid0 ) )
show me the job with a salary of with num_salary	( answer ( job ANS ) ( salary_greater_than ANS num_salary year ) )
show me job that that require year0 year work experience in languageid0	( answer ( job ANS ) ( req_exp ANS year0 ) ( language ANS languageid0 ) )
what job are there for languageid0 program who dont for know languageid1	( answer ( job ANS ) ( language ANS languageid0 ) ( \+ ( language ANS languageid1 ) ) )
what job in locid0 require languageid0 in and platformid0	( answer ( job ANS ) ( loc ANS locid0 ) ( language ANS languageid0 ) ( platform ANS platformid0 ) )
what are the job in locid0 that require year0 at least year0 year of experience	( answer ( job ANS ) ( loc ANS locid0 ) ( req_exp ANS year0 ) )
with show me job desire a degid0 in locid0 with companyid0	( answer ( job ANS ) ( des_deg ANS degid0 ) ( loc ANS locid0 ) ( company ANS companyid0 ) )
what in job pay num_salary are location in locid0 and require a degid0	( answer ( job ANS ) ( salary_greater_than ANS num_salary year ) ( loc ANS locid0 ) ( req_deg ANS degid0 ) )
what job pay num_salary are location in locid0 and and require a degid0	( answer ( job ANS ) ( salary_greater_than ANS num_salary year ) ( loc ANS locid0 ) ( req_deg ANS degid0 ) )
show me me job at companyid0 earn num_salary	( answer ( job ANS ) ( company ANS companyid0 ) ( salary_greater_than ANS num_salary year ) )
are there any job at companyid0 that are require a degid0	( answer ( job ANS ) ( company ANS companyid0 ) ( req_deg ANS degid0 ) )
list all job use languageid0 and languageid1 in locid0 and	( answer ( job ANS ) ( language ANS languageid0 ) ( language ANS languageid1 ) ( loc ANS locid0 ) )
show me job use languageid0 that require a degid0 and desire a degid1 and	( answer ( job ANS ) ( language ANS languageid0 ) ( req_deg ANS degid0 ) ( des_deg ANS degid1 ) )
id like to see the job in in locid0 for a languageid0 titleid0 make at least num_salary a year invlov areaid0	( answer ( job ANS ) ( loc ANS locid0 ) ( language ANS languageid0 ) ( title ANS titleid0 ) ( salary_greater_than ANS num_salary year ) ( area ANS areaid0 ) )
list job in locid0 ? in	( answer ( job ANS ) ( loc ANS locid0 ) )
what job are avail for a platformid0 for titleid0	( answer ( job ANS ) ( platform ANS platformid0 ) ( title ANS titleid0 ) )
what kind of job could i find for for an old languageid0 titleid0	( answer ( job ANS ) ( language ANS languageid0 ) ( title ANS titleid0 ) )
show me job use languageid0 that require a me degid0 and desire a degid1	( answer ( job ANS ) ( language ANS languageid0 ) ( req_deg ANS degid0 ) ( des_deg ANS degid1 ) )
list the job in locid0 in	( answer ( job ANS ) ( loc ANS locid0 ) )
what areaid0 job are there in in locid0 that pay num_salary	( answer ( area ANS areaid0 ) ( job ANS ) ( loc ANS locid0 ) ( salary_greater_than ANS num_salary year ) )
list job in in locid0	( answer ( job ANS ) ( loc ANS locid0 ) )
in show me job in locid0	( answer ( job ANS ) ( loc ANS locid0 ) )
for give me the job for a areaid0 specialist	( answer ( job ANS ) ( area ANS areaid0 ) )
show me me the job with a salary of num_salary	( answer ( job ANS ) ( salary_greater_than ANS num_salary year ) )
give me job in locid0 in	( answer ( job ANS ) ( loc ANS locid0 ) )
tell me job in in locid0	( answer ( job ANS ) ( loc ANS locid0 ) )
show me the job with a salary of of num_salary	( answer ( job ANS ) ( salary_greater_than ANS num_salary year ) )
show me the job that oper on platformid0 ? me	( answer ( job ANS ) ( platform ANS platformid0 ) )
what are the job use languageid0 with with salary of num_salary	( answer ( job ANS ) ( language ANS languageid0 ) ( salary_greater_than ANS num_salary year ) )
are there any job are use languageid0 that dont require a degid0	( answer ( job ANS ) ( language ANS languageid0 ) ( \+ ( req_deg ANS degid0 ) ) )
what within are the position within companyid0 that require degid0	( answer ( job ANS ) ( company ANS companyid0 ) ( req_deg ANS degid0 ) )
are there are any computer job for the platformid0	( answer ( job ANS ) ( platform ANS platformid0 ) )
what job require a degid0 and pay more per than num_salary per year	( answer ( job ANS ) ( req_deg ANS degid0 ) ( salary_greater_than ANS num_salary year ) )
what job and require a degid0 and pay more than num_salary per year	( answer ( job ANS ) ( req_deg ANS degid0 ) ( salary_greater_than ANS num_salary year ) )
list job on on platformid0	( answer ( job ANS ) ( platform ANS platformid0 ) )
what on job can a languageid0 titleid0 find in locid0 on platformid0	( answer ( job ANS ) ( language ANS languageid0 ) ( title ANS titleid0 ) ( loc ANS locid0 ) ( platform ANS platformid0 ) )
what job are in locid0 are that are not at companyid0	( answer ( job ANS ) ( loc ANS locid0 ) ( \+ ( company ANS companyid0 ) ) )
show me the job that require year0 of year of experience but desire year1 year of experience	( answer ( job ANS ) ( req_exp ANS year0 ) ( des_exp ANS year1 ) )
within what are the position within companyid0 that require degid0	( answer ( job ANS ) ( company ANS companyid0 ) ( req_deg ANS degid0 ) )
what job in locid0 require and languageid0 and platformid0	( answer ( job ANS ) ( loc ANS locid0 ) ( language ANS languageid0 ) ( platform ANS platformid0 ) )
year0 what are the job in locid0 that require at least year0 year of experience	( answer ( job ANS ) ( loc ANS locid0 ) ( req_exp ANS year0 ) )
what job can a languageid0 in titleid0 find in locid0 on platformid0	( answer ( job ANS ) ( language ANS languageid0 ) ( title ANS titleid0 ) ( loc ANS locid0 ) ( platform ANS platformid0 ) )
tell me the job me use languageid0	( answer ( job ANS ) ( language ANS languageid0 ) )
what kind of job could i of find for an old languageid0 titleid0	( answer ( job ANS ) ( language ANS languageid0 ) ( title ANS titleid0 ) )
what can i find use languageid0 on on platformid0	( answer ( job ANS ) ( language ANS languageid0 ) ( platform ANS platformid0 ) )
are there any computer job for the are platformid0	( answer ( job ANS ) ( platform ANS platformid0 ) )
what job in locid0 in require a degid0	( answer ( job ANS ) ( loc ANS locid0 ) ( req_deg ANS degid0 ) )
give me the me job in locid0	( answer ( job ANS ) ( loc ANS locid0 ) )
id like to see the job in locid0 for a languageid0 titleid0 make at least num_salary a year invlov areaid0 ? in	( answer ( job ANS ) ( loc ANS locid0 ) ( language ANS languageid0 ) ( title ANS titleid0 ) ( salary_greater_than ANS num_salary year ) ( area ANS areaid0 ) )
list all job use languageid0 and languageid1 in locid0 in	( answer ( job ANS ) ( language ANS languageid0 ) ( language ANS languageid1 ) ( loc ANS locid0 ) )
give me the job on platformid0 in me languageid0	( answer ( job ANS ) ( platform ANS platformid0 ) ( language ANS languageid0 ) )
give some job in locid0 on a platformid0 in system	( answer ( job ANS ) ( loc ANS locid0 ) ( platform ANS platformid0 ) )
give me the job use me languageid0	( answer ( job ANS ) ( language ANS languageid0 ) )
give me the job for for a areaid0 specialist	( answer ( job ANS ) ( area ANS areaid0 ) )
what are the position within companyid0 that require degid0 ? within	( answer ( job ANS ) ( company ANS companyid0 ) ( req_deg ANS degid0 ) )
what job can a languageid0 titleid0 find can in locid0 on platformid0	( answer ( job ANS ) ( language ANS languageid0 ) ( title ANS titleid0 ) ( loc ANS locid0 ) ( platform ANS platformid0 ) )
what job pay num_salary are location in locid0 and require a degree ? and	( answer ( job ANS ) ( salary_greater_than ANS num_salary year ) ( loc ANS locid0 ) ( req_deg ANS ) )
show me job use languageid0 that require a degid0 me and desire a degid1	( answer ( job ANS ) ( language ANS languageid0 ) ( req_deg ANS degid0 ) ( des_deg ANS degid1 ) )
are there any job with companyid0 involve with languageid0	( answer ( job ANS ) ( company ANS companyid0 ) ( language ANS languageid0 ) )
what job are avail ? are	( answer ( job ANS ) )
give me the job on on platformid0	( answer ( job ANS ) ( platform ANS platformid0 ) )
what languageid0 in job are there with companyid0 in locid0	( answer ( language ANS languageid0 ) ( job ANS ) ( company ANS companyid0 ) ( loc ANS locid0 ) )
which job pay num_salary that do not require a degid0 ? do	( answer ( job ANS ) ( salary_greater_than ANS num_salary year ) ( \+ ( req_deg ANS degid0 ) ) )
are there any job require a degid0 for companyid0 in locid0 ? for	( answer ( job ANS ) ( req_deg ANS degid0 ) ( company ANS companyid0 ) ( loc ANS locid0 ) )
give me the job me use languageid0	( answer ( job ANS ) ( language ANS languageid0 ) )
show me job at me companyid0 earn num_salary	( answer ( job ANS ) ( company ANS companyid0 ) ( salary_greater_than ANS num_salary year ) )
what per job require a degid0 and pay more than num_salary per year	( answer ( job ANS ) ( req_deg ANS degid0 ) ( salary_greater_than ANS num_salary year ) )
what job can a languageid0 titleid0 find in san on antonio on platformid0	( answer ( job ANS ) ( language ANS languageid0 ) ( title ANS titleid0 ) ( loc ANS locid0 ) ( platform ANS platformid0 ) )
what in job in locid0 are there that pay at least num_salary per year	( answer ( job ANS ) ( loc ANS locid0 ) ( salary_greater_than ANS num_salary year ) )
show me the job with a salary of num_salary of	( answer ( job ANS ) ( salary_greater_than ANS num_salary year ) )
show and all titleid0 position in locid0 with areaid0 and languageid0	( answer ( title ANS titleid0 ) ( job ANS ) ( loc ANS locid0 ) ( area ANS areaid0 ) ( language ANS languageid0 ) )
what at job in locid0 are there that pay at least num_salary per year	( answer ( job ANS ) ( loc ANS locid0 ) ( salary_greater_than ANS num_salary year ) )
show me all of the areaid0 job me in locid0	( answer ( area ANS areaid0 ) ( job ANS ) ( loc ANS locid0 ) )
give me the job on platformid0 ? on	( answer ( job ANS ) ( platform ANS platformid0 ) )
are there any job at companyid0 that require a degid0 are	( answer ( job ANS ) ( company ANS companyid0 ) ( req_deg ANS degid0 ) )
tell in me the job in areaid0	( answer ( job ANS ) ( area ANS areaid0 ) )
are there any job in locid0 ? are	( answer ( job ANS ) ( loc ANS locid0 ) )
show me locid0 job use languageid0 on on platformid0	( answer ( loc ANS locid0 ) ( job ANS ) ( language ANS languageid0 ) ( platform ANS platformid0 ) )
there must be some job out there for a languageid0 titleid0 that that think in platformid0 areaid0	( answer ( job ANS ) ( language ANS languageid0 ) ( title ANS titleid0 ) ( platform ANS platformid0 ) ( area ANS areaid0 ) )
give me job in locid0 me	( answer ( job ANS ) ( loc ANS locid0 ) )
show me job me in locid0	( answer ( job ANS ) ( loc ANS locid0 ) )
show me the languageid0 job in locid0 that desire me year0 year experience	( answer ( language ANS languageid0 ) ( job ANS ) ( loc ANS locid0 ) ( des_exp ANS year0 ) )
are there any job in locid0 are	( answer ( job ANS ) ( loc ANS locid0 ) )
show me the areaid0 job in locid0 with a salary of of num_salary	( answer ( area ANS areaid0 ) ( job ANS ) ( loc ANS locid0 ) ( salary_greater_than ANS num_salary year ) )
list on job on platformid0	( answer ( job ANS ) ( platform ANS platformid0 ) )
list in job in locid0	( answer ( job ANS ) ( loc ANS locid0 ) )
show for job for a areaid0 specialist	( answer ( job ANS ) ( area ANS areaid0 ) )
are there any job with are a salary of num_salary	( answer ( job ANS ) ( salary_greater_than ANS num_salary year ) )
what languageid0 with job are there with companyid0 in locid0	( answer ( language ANS languageid0 ) ( job ANS ) ( company ANS companyid0 ) ( loc ANS locid0 ) )
show me locid0 job require a degid0 ? me	( answer ( loc ANS locid0 ) ( job ANS ) ( req_deg ANS degid0 ) )
can you show me all you the job	( answer ( job ANS ) )
tell me me job on platformid0	( answer ( job ANS ) ( platform ANS platformid0 ) )
give me the in job in locid0	( answer ( job ANS ) ( loc ANS locid0 ) )
list job on platformid0 ? on	( answer ( job ANS ) ( platform ANS platformid0 ) )
give me job in locid0 in	( answer ( job ANS ) ( loc ANS locid0 ) )
are tell me what job there are	( answer ( job ANS ) )
what are the job use languageid0 with salary of num_salary of	( answer ( job ANS ) ( language ANS languageid0 ) ( salary_greater_than ANS num_salary year ) )
show me locid0 me job desire a degid0	( answer ( loc ANS locid0 ) ( job ANS ) ( des_deg ANS degid0 ) )
there must be some job out there for a out languageid0 titleid0 that think in platformid0 areaid0	( answer ( job ANS ) ( language ANS languageid0 ) ( title ANS titleid0 ) ( platform ANS platformid0 ) ( area ANS areaid0 ) )
what job are there for languageid0 program are who dont know languageid1	( answer ( job ANS ) ( language ANS languageid0 ) ( \+ ( language ANS languageid1 ) ) )
what job are are there in languageid0	( answer ( job ANS ) ( language ANS languageid0 ) )
id like to see in the job in locid0 for a languageid0 titleid0 make at least num_salary a year invlov areaid0	( answer ( job ANS ) ( loc ANS locid0 ) ( language ANS languageid0 ) ( title ANS titleid0 ) ( salary_greater_than ANS num_salary year ) ( area ANS areaid0 ) )
show me job that require year0 year work experience in languageid0 that	( answer ( job ANS ) ( req_exp ANS year0 ) ( language ANS languageid0 ) )
are there are any job use languageid0 that dont require a degid0	( answer ( job ANS ) ( language ANS languageid0 ) ( \+ ( req_deg ANS degid0 ) ) )
are there any job with are companyid0 involve languageid0	( answer ( job ANS ) ( company ANS companyid0 ) ( language ANS languageid0 ) )
show job for for a areaid0 specialist	( answer ( job ANS ) ( area ANS areaid0 ) )
what do job do you have	( answer ( job ANS ) )
on what job use languageid0 on platformid0 machin and pay num_salary	( answer ( job ANS ) ( language ANS languageid0 ) ( platform ANS platformid0 ) ( salary_greater_than ANS num_salary year ) )
show me the job with a with salary of num_salary	( answer ( job ANS ) ( salary_greater_than ANS num_salary year ) )
what areaid0 job are there in locid0 that pay are num_salary	( answer ( area ANS areaid0 ) ( job ANS ) ( loc ANS locid0 ) ( salary_greater_than ANS num_salary year ) )
are what job are there on platformid0	( answer ( job ANS ) ( platform ANS platformid0 ) )
what languageid0 job are there with companyid0 in locid0 ? in	( answer ( language ANS languageid0 ) ( job ANS ) ( company ANS companyid0 ) ( loc ANS locid0 ) )
year0 list the job require languageid0 a degid0 year0 year experience	( answer ( job ANS ) ( language ANS languageid0 ) ( req_deg ANS degid0 ) ( req_exp ANS year0 ) )
what could kind of job could i find for an old languageid0 titleid0	( answer ( job ANS ) ( language ANS languageid0 ) ( title ANS titleid0 ) )
give me the job on me platformid0	( answer ( job ANS ) ( platform ANS platformid0 ) )
show me the job use languageid0 me with salary greater than num_salary per year	( answer ( job ANS ) ( language ANS languageid0 ) ( salary_greater_than ANS num_salary year ) )
on are there any job on platformid0	( answer ( job ANS ) ( platform ANS platformid0 ) )
what can i find use on languageid0 on platformid0	( answer ( job ANS ) ( language ANS languageid0 ) ( platform ANS platformid0 ) )
are are there any job in locid0	( answer ( job ANS ) ( loc ANS locid0 ) )
give me on the job on platformid0	( answer ( job ANS ) ( platform ANS platformid0 ) )
tell me the me job in locid0	( answer ( job ANS ) ( loc ANS locid0 ) )
can you show me all the job ? you	( answer ( job ANS ) )
give in me the job in locid0	( answer ( job ANS ) ( loc ANS locid0 ) )
tell me me job require degid0	( answer ( job ANS ) ( req_deg ANS degid0 ) )
tell on me job on platformid0	( answer ( job ANS ) ( platform ANS platformid0 ) )
list the job in in locid0	( answer ( job ANS ) ( loc ANS locid0 ) )
are there any job in languageid0 that that the salary is num_salary	( answer ( job ANS ) ( language ANS languageid0 ) ( salary_greater_than ANS num_salary year ) )
me show me locid0 job desire a degid0	( answer ( loc ANS locid0 ) ( job ANS ) ( des_deg ANS degid0 ) )
show me the job require year0 year of experience at companyid0 year0	( answer ( job ANS ) ( req_exp ANS year0 ) ( company ANS companyid0 ) )
what on job are there on platformid0	( answer ( job ANS ) ( platform ANS platformid0 ) )
with show me the areaid0 job in locid0 with a salary of num_salary	( answer ( area ANS areaid0 ) ( job ANS ) ( loc ANS locid0 ) ( salary_greater_than ANS num_salary year ) )
what job are avail for a platformid0 system are administration	( answer ( job ANS ) ( platform ANS platformid0 ) ( title ANS titleid0 ) )
show me the job which use applicationid0 me	( answer ( job ANS ) ( application ANS applicationid0 ) )
what are job are there on platformid0 involve the areaid0	( answer ( job ANS ) ( platform ANS platformid0 ) ( area ANS areaid0 ) )
which job pay do num_salary that do not require a degid0	( answer ( job ANS ) ( salary_greater_than ANS num_salary year ) ( \+ ( req_deg ANS degid0 ) ) )
what job are avail for a for platformid0 titleid0	( answer ( job ANS ) ( platform ANS platformid0 ) ( title ANS titleid0 ) )
list the in job in locid0	( answer ( job ANS ) ( loc ANS locid0 ) )
what are year0 the job in locid0 that require at least year0 year of experience	( answer ( job ANS ) ( loc ANS locid0 ) ( req_exp ANS year0 ) )
show the on job on platformid0	( answer ( job ANS ) ( platform ANS platformid0 ) )
what job are there in are languageid0	( answer ( job ANS ) ( language ANS languageid0 ) )
give me me the job use languageid0	( answer ( job ANS ) ( language ANS languageid0 ) )
tell me job require me degid0	( answer ( job ANS ) ( req_deg ANS degid0 ) )
are there any job for a for areaid0 specialist	( answer ( job ANS ) ( area ANS areaid0 ) )
what job are there for a areaid0 specialist for	( answer ( job ANS ) ( area ANS areaid0 ) )
show me locid0 job use languageid0 me on platformid0	( answer ( loc ANS locid0 ) ( job ANS ) ( language ANS languageid0 ) ( platform ANS platformid0 ) )
what job are there use languageid0 are	( answer ( job ANS ) ( language ANS languageid0 ) )
are there are any job use languageid0	( answer ( job ANS ) ( language ANS languageid0 ) )
what position in companyid0 do do i need a degid0 to work	( answer ( job ANS ) ( company ANS companyid0 ) ( req_deg ANS degid0 ) )
does does anyon still use platformid0	( answer ( job ANS ) ( platform ANS platformid0 ) )
tell me job for a areaid0 specialist me	( answer ( job ANS ) ( area ANS areaid0 ) )
are there any job with a are salary of num_salary	( answer ( job ANS ) ( salary_greater_than ANS num_salary year ) )
list the job in san in antonio	( answer ( job ANS ) ( loc ANS locid0 ) )
show me me job in locid0	( answer ( job ANS ) ( loc ANS locid0 ) )
on what job are there do computer areaid0 on platformid0 machin	( answer ( job ANS ) ( area ANS areaid0 ) ( platform ANS platformid0 ) )
what job pay num_salary are location in locid0 and require are a degree	( answer ( job ANS ) ( salary_greater_than ANS num_salary year ) ( loc ANS locid0 ) ( req_deg ANS ) )
what are job are avail	( answer ( job ANS ) )
what is out there ? is	( answer ( job ANS ) )
what are job are there do computer areaid0 on platformid0 machin	( answer ( job ANS ) ( area ANS areaid0 ) ( platform ANS platformid0 ) )
show me the areaid0 job in locid0 with a salary me of num_salary	( answer ( area ANS areaid0 ) ( job ANS ) ( loc ANS locid0 ) ( salary_greater_than ANS num_salary year ) )
what are the position within companyid0 that require degid0 are	( answer ( job ANS ) ( company ANS companyid0 ) ( req_deg ANS degid0 ) )
in tell me the job in locid0	( answer ( job ANS ) ( loc ANS locid0 ) )
me show me the job which use applicationid0	( answer ( job ANS ) ( application ANS applicationid0 ) )
show the job on on platformid0	( answer ( job ANS ) ( platform ANS platformid0 ) )
id like to see the job in locid0 for a languageid0 in titleid0 make at least num_salary a year invlov areaid0	( answer ( job ANS ) ( loc ANS locid0 ) ( language ANS languageid0 ) ( title ANS titleid0 ) ( salary_greater_than ANS num_salary year ) ( area ANS areaid0 ) )
give me the job on platformid0 in languageid0 me	( answer ( job ANS ) ( platform ANS platformid0 ) ( language ANS languageid0 ) )
tell me me job require degid0	( answer ( job ANS ) ( req_deg ANS degid0 ) )
what job are there do computer areaid0 on on platformid0 machin	( answer ( job ANS ) ( area ANS areaid0 ) ( platform ANS platformid0 ) )
give me job in locid0 me	( answer ( job ANS ) ( loc ANS locid0 ) )
show with me job desire a degid0 in locid0 with companyid0	( answer ( job ANS ) ( des_deg ANS degid0 ) ( loc ANS locid0 ) ( company ANS companyid0 ) )
are there any job in languageid0 that are the salary is num_salary	( answer ( job ANS ) ( language ANS languageid0 ) ( salary_greater_than ANS num_salary year ) )
show me job that require year0 year work that experience in languageid0	( answer ( job ANS ) ( req_exp ANS year0 ) ( language ANS languageid0 ) )
what job pay num_salary are location in locid0 and require a degid0 in	( answer ( job ANS ) ( salary_greater_than ANS num_salary year ) ( loc ANS locid0 ) ( req_deg ANS degid0 ) )
are there any job in at locid0 require at least a degid0 and know languageid0	( answer ( job ANS ) ( loc ANS locid0 ) ( req_deg ANS degid0 ) ( language ANS languageid0 ) )
on what can i find use languageid0 on platformid0	( answer ( job ANS ) ( language ANS languageid0 ) ( platform ANS platformid0 ) )
what job are avail for a platformid0 titleid0 for	( answer ( job ANS ) ( platform ANS platformid0 ) ( title ANS titleid0 ) )
with show me the job with a salary of num_salary	( answer ( job ANS ) ( salary_greater_than ANS num_salary year ) )
what areaid0 job are there in locid0 in that pay num_salary	( answer ( area ANS areaid0 ) ( job ANS ) ( loc ANS locid0 ) ( salary_greater_than ANS num_salary year ) )
what job use languageid0 and and languageid1 are avail in locid0 and pay num_salary a year	( answer ( job ANS ) ( language ANS languageid0 ) ( language ANS languageid1 ) ( loc ANS locid0 ) ( salary_greater_than ANS num_salary year ) )
what job are there in locid0 require a in degid0	( answer ( job ANS ) ( loc ANS locid0 ) ( req_deg ANS degid0 ) )
give me job in in locid0	( answer ( job ANS ) ( loc ANS locid0 ) )
show me me titleid0 job require no experience on platformid0	( answer ( title ANS titleid0 ) ( job ANS ) ( \+ ( ( req_exp ANS ) ( platform ANS platformid0 ) ) ) )
what job are there for a for areaid0 specialist	( answer ( job ANS ) ( area ANS areaid0 ) )
are there any on job on platformid0	( answer ( job ANS ) ( platform ANS platformid0 ) )
what job are there that dont require a degree but use languageid0 ? that	( answer ( job ANS ) ( \+ ( req_deg ANS ) ) ( language ANS languageid0 ) )
give me the for job for a areaid0 specialist	( answer ( job ANS ) ( area ANS areaid0 ) )
what are are the job in locid0 that require at least year0 year of experience	( answer ( job ANS ) ( loc ANS locid0 ) ( req_exp ANS year0 ) )
can you show me all me the job	( answer ( job ANS ) )
what in job are there in locid0 require a degid0	( answer ( job ANS ) ( loc ANS locid0 ) ( req_deg ANS degid0 ) )
for what job are there for languageid0 program who dont know languageid1	( answer ( job ANS ) ( language ANS languageid0 ) ( \+ ( language ANS languageid1 ) ) )
what job in locid0 require languageid0 and platformid0 ? and	( answer ( job ANS ) ( loc ANS locid0 ) ( language ANS languageid0 ) ( platform ANS platformid0 ) )
are what job are there use languageid0	( answer ( job ANS ) ( language ANS languageid0 ) )
tell in me job in locid0	( answer ( job ANS ) ( loc ANS locid0 ) )
what job in locid0 are there that pay at least num_salary per year at	( answer ( job ANS ) ( loc ANS locid0 ) ( salary_greater_than ANS num_salary year ) )
tell me what job there are are	( answer ( job ANS ) )
are there any job is in languageid0 that the salary is num_salary	( answer ( job ANS ) ( language ANS languageid0 ) ( salary_greater_than ANS num_salary year ) )
there must must be some job out there for a languageid0 titleid0 that think in platformid0 areaid0	( answer ( job ANS ) ( language ANS languageid0 ) ( title ANS titleid0 ) ( platform ANS platformid0 ) ( area ANS areaid0 ) )
what job are there that that dont require a degree but use languageid0	( answer ( job ANS ) ( \+ ( req_deg ANS ) ) ( language ANS languageid0 ) )
can you you show me all the job	( answer ( job ANS ) )
what job and pay num_salary are location in locid0 and require a degree	( answer ( job ANS ) ( salary_greater_than ANS num_salary year ) ( loc ANS locid0 ) ( req_deg ANS ) )
what and job pay num_salary are location in locid0 and require a degid0	( answer ( job ANS ) ( salary_greater_than ANS num_salary year ) ( loc ANS locid0 ) ( req_deg ANS degid0 ) )
which job pay num_salary that do not require a do degid0	( answer ( job ANS ) ( salary_greater_than ANS num_salary year ) ( \+ ( req_deg ANS degid0 ) ) )
list job on platformid0 on	( answer ( job ANS ) ( platform ANS platformid0 ) )
what job in locid0 only require a degid0 and no experience ? in	( answer ( job ANS ) ( loc ANS locid0 ) ( req_deg ANS degid0 ) ( \+ ( req_exp ANS ) ) )
what are job are there in languageid0	( answer ( job ANS ) ( language ANS languageid0 ) )
give me on the job on platformid0 in languageid0	( answer ( job ANS ) ( platform ANS platformid0 ) ( language ANS languageid0 ) )
