give the job use languageid0 that dont require platformid0	( answer ( job ANS ) ( language ANS languageid0 ) ( \+ ( platform ANS platformid0 ) ) )
show the job which use applicationid0	( answer ( job ANS ) ( application ANS applicationid0 ) )
show all of the areaid0 job in locid0	( answer ( area ANS areaid0 ) ( job ANS ) ( loc ANS locid0 ) )
what job do you	( answer ( job ANS ) )
what job there do computer areaid0 on platformid0 machin	( answer ( job ANS ) ( area ANS areaid0 ) ( platform ANS platformid0 ) )
are there any job with a salary num_salary	( answer ( job ANS ) ( salary_greater_than ANS num_salary year ) )
show the job use languageid0 with salary greater than num_salary per year	( answer ( job ANS ) ( language ANS languageid0 ) ( salary_greater_than ANS num_salary year ) )
show job use languageid0 that require a degid0 and desire a degid1	( answer ( job ANS ) ( language ANS languageid0 ) ( req_deg ANS degid0 ) ( des_deg ANS degid1 ) )
list all job use languageid0 languageid1 in locid0	( answer ( job ANS ) ( language ANS languageid0 ) ( language ANS languageid1 ) ( loc ANS locid0 ) )
what areaid0 job are there locid0 that pay num_salary	( answer ( area ANS areaid0 ) ( job ANS ) ( loc ANS locid0 ) ( salary_greater_than ANS num_salary year ) )
there any job in locid0	( answer ( job ANS ) ( loc ANS locid0 ) )
are there any job in languageid0 the salary is num_salary	( answer ( job ANS ) ( language ANS languageid0 ) ( salary_greater_than ANS num_salary year ) )
give me the job a areaid0 specialist	( answer ( job ANS ) ( area ANS areaid0 ) )
show me job that require year0 year work experience languageid0	( answer ( job ANS ) ( req_exp ANS year0 ) ( language ANS languageid0 ) )
what job in locid0 are there that pay least num_salary per year	( answer ( job ANS ) ( loc ANS locid0 ) ( salary_greater_than ANS num_salary year ) )
show me the job that oper platformid0	( answer ( job ANS ) ( platform ANS platformid0 ) )
show the job with a salary of num_salary	( answer ( job ANS ) ( salary_greater_than ANS num_salary year ) )
give me job locid0	( answer ( job ANS ) ( loc ANS locid0 ) )
show the languageid0 job in locid0 that desire year0 year experience	( answer ( language ANS languageid0 ) ( job ANS ) ( loc ANS locid0 ) ( des_exp ANS year0 ) )
there any job use languageid0 that dont require a degid0	( answer ( job ANS ) ( language ANS languageid0 ) ( \+ ( req_deg ANS degid0 ) ) )
are there any job locid0	( answer ( job ANS ) ( loc ANS locid0 ) )
what are the job in locid0 that require at least year0 year experience	( answer ( job ANS ) ( loc ANS locid0 ) ( req_exp ANS year0 ) )
what job in locid0 require languageid0 platformid0	( answer ( job ANS ) ( loc ANS locid0 ) ( language ANS languageid0 ) ( platform ANS platformid0 ) )
tell job require degid0	( answer ( job ANS ) ( req_deg ANS degid0 ) )
show me the languageid0 job in locid0 desire year0 year experience	( answer ( language ANS languageid0 ) ( job ANS ) ( loc ANS locid0 ) ( des_exp ANS year0 ) )
what position companyid0 do i need a degid0 to work	( answer ( job ANS ) ( company ANS companyid0 ) ( req_deg ANS degid0 ) )
list job platformid0	( answer ( job ANS ) ( platform ANS platformid0 ) )
what job are there languageid0	( answer ( job ANS ) ( language ANS languageid0 ) )
what job pay num_salary location in locid0 and require a degree	( answer ( job ANS ) ( salary_greater_than ANS num_salary year ) ( loc ANS locid0 ) ( req_deg ANS ) )
are there any job in locid0 require least a degid0 and know languageid0	( answer ( job ANS ) ( loc ANS locid0 ) ( req_deg ANS degid0 ) ( language ANS languageid0 ) )
what job use languageid0 languageid1 are avail in locid0 and pay num_salary a year	( answer ( job ANS ) ( language ANS languageid0 ) ( language ANS languageid1 ) ( loc ANS locid0 ) ( salary_greater_than ANS num_salary year ) )
what job locid0 require languageid0 and platformid0	( answer ( job ANS ) ( loc ANS locid0 ) ( language ANS languageid0 ) ( platform ANS platformid0 ) )
what job avail	( answer ( job ANS ) )
what can i find use languageid0 platformid0	( answer ( job ANS ) ( language ANS languageid0 ) ( platform ANS platformid0 ) )
tell the job use languageid0	( answer ( job ANS ) ( language ANS languageid0 ) )
give me the job platformid0	( answer ( job ANS ) ( platform ANS platformid0 ) )
anyon still use platformid0	( answer ( job ANS ) ( platform ANS platformid0 ) )
id like to see the job locid0 for a languageid0 titleid0 make at least num_salary a year invlov areaid0	( answer ( job ANS ) ( loc ANS locid0 ) ( language ANS languageid0 ) ( title ANS titleid0 ) ( salary_greater_than ANS num_salary year ) ( area ANS areaid0 ) )
show me titleid0 job require no experience platformid0	( answer ( title ANS titleid0 ) ( job ANS ) ( \+ ( ( req_exp ANS ) ( platform ANS platformid0 ) ) ) )
what job use languageid0 and languageid1 avail in locid0 and pay num_salary a year	( answer ( job ANS ) ( language ANS languageid0 ) ( language ANS languageid1 ) ( loc ANS locid0 ) ( salary_greater_than ANS num_salary year ) )
tell what job there are	( answer ( job ANS ) )
what i find use languageid0 on platformid0	( answer ( job ANS ) ( language ANS languageid0 ) ( platform ANS platformid0 ) )
show me the job use languageid0 with salary greater than num_salary year	( answer ( job ANS ) ( language ANS languageid0 ) ( salary_greater_than ANS num_salary year ) )
show me the job that require year of experience but desire year0 year of experience	( answer ( job ANS ) ( req_exp ANS year0 ) ( des_exp ANS year1 ) )
what languageid0 job are there with companyid0 locid0	( answer ( language ANS languageid0 ) ( job ANS ) ( company ANS companyid0 ) ( loc ANS locid0 ) )
tell me the job areaid0	( answer ( job ANS ) ( area ANS areaid0 ) )
what areaid0 job there in locid0 that pay num_salary	( answer ( area ANS areaid0 ) ( job ANS ) ( loc ANS locid0 ) ( salary_greater_than ANS num_salary year ) )
give me the job platformid0	( answer ( job ANS ) ( platform ANS platformid0 ) )
what job pay num_salary are location locid0 and require a degree	( answer ( job ANS ) ( salary_greater_than ANS num_salary year ) ( loc ANS locid0 ) ( req_deg ANS ) )
are there any computer job the platformid0	( answer ( job ANS ) ( platform ANS platformid0 ) )
what job require a degid0 and pay more num_salary per year	( answer ( job ANS ) ( req_deg ANS degid0 ) ( salary_greater_than ANS num_salary year ) )
show me job desire a degid0 in locid0 companyid0	( answer ( job ANS ) ( des_deg ANS degid0 ) ( loc ANS locid0 ) ( company ANS companyid0 ) )
show titleid0 job require no experience on platformid0	( answer ( title ANS titleid0 ) ( job ANS ) ( \+ ( ( req_exp ANS ) ( platform ANS platformid0 ) ) ) )
show job in locid0	( answer ( job ANS ) ( loc ANS locid0 ) )
show job at companyid0 earn num_salary	( answer ( job ANS ) ( company ANS companyid0 ) ( salary_greater_than ANS num_salary year ) )
what job companyid0 require a degid0	( answer ( job ANS ) ( company ANS companyid0 ) ( req_deg ANS degid0 ) )
what job there on platformid0 involve the areaid0	( answer ( job ANS ) ( platform ANS platformid0 ) ( area ANS areaid0 ) )
show job desire a degid0 in locid0 with companyid0	( answer ( job ANS ) ( des_deg ANS degid0 ) ( loc ANS locid0 ) ( company ANS companyid0 ) )
what job are there a areaid0 specialist	( answer ( job ANS ) ( area ANS areaid0 ) )
show me the languageid0 job in locid0 that desire year experience	( answer ( language ANS languageid0 ) ( job ANS ) ( loc ANS locid0 ) ( des_exp ANS year0 ) )
tell the job in locid0	( answer ( job ANS ) ( loc ANS locid0 ) )
list all job use languageid0 and languageid1 locid0	( answer ( job ANS ) ( language ANS languageid0 ) ( language ANS languageid1 ) ( loc ANS locid0 ) )
what job there use languageid0	( answer ( job ANS ) ( language ANS languageid0 ) )
tell me job locid0	( answer ( job ANS ) ( loc ANS locid0 ) )
what kind of job i find for an old languageid0 titleid0	( answer ( job ANS ) ( language ANS languageid0 ) ( title ANS titleid0 ) )
there any job in locid0 require at least a degid0 and know languageid0	( answer ( job ANS ) ( loc ANS locid0 ) ( req_deg ANS degid0 ) ( language ANS languageid0 ) )
what job locid0 only require a degid0 and no experience	( answer ( job ANS ) ( loc ANS locid0 ) ( req_deg ANS degid0 ) ( \+ ( req_exp ANS ) ) )
show me the areaid0 job in locid0 with a salary num_salary	( answer ( area ANS areaid0 ) ( job ANS ) ( loc ANS locid0 ) ( salary_greater_than ANS num_salary year ) )
what job there use languageid0	( answer ( job ANS ) ( language ANS languageid0 ) )
there any job with a salary of num_salary	( answer ( job ANS ) ( salary_greater_than ANS num_salary year ) )
tell the job in areaid0	( answer ( job ANS ) ( area ANS areaid0 ) )
give the job on platformid0 in languageid0	( answer ( job ANS ) ( platform ANS platformid0 ) ( language ANS languageid0 ) )
give me the job languageid0	( answer ( job ANS ) ( language ANS languageid0 ) )
what position in companyid0 i need a degid0 to work	( answer ( job ANS ) ( company ANS companyid0 ) ( req_deg ANS degid0 ) )
show me position areaid0 program	( answer ( job ANS ) ( area ANS areaid0 ) )
give the job for a areaid0 specialist	( answer ( job ANS ) ( area ANS areaid0 ) )
are there any job companyid0	( answer ( job ANS ) ( company ANS companyid0 ) )
what are the job in locid0 require at least year0 year of experience	( answer ( job ANS ) ( loc ANS locid0 ) ( req_exp ANS year0 ) )
what job there for a areaid0 specialist	( answer ( job ANS ) ( area ANS areaid0 ) )
what job pay num_salary are location in locid0 require a degree	( answer ( job ANS ) ( salary_greater_than ANS num_salary year ) ( loc ANS locid0 ) ( req_deg ANS ) )
what job use languageid0 on platformid0 machin pay num_salary	( answer ( job ANS ) ( language ANS languageid0 ) ( platform ANS platformid0 ) ( salary_greater_than ANS num_salary year ) )
show the job that oper on platformid0	( answer ( job ANS ) ( platform ANS platformid0 ) )
tell job for a areaid0 specialist	( answer ( job ANS ) ( area ANS areaid0 ) )
give me job locid0	( answer ( job ANS ) ( loc ANS locid0 ) )
give me the job locid0	( answer ( job ANS ) ( loc ANS locid0 ) )
what are the job that pay num_salary year	( answer ( job ANS ) ( salary_greater_than ANS num_salary year ) )
what job use languageid0 and languageid1 are avail locid0 and pay num_salary a year	( answer ( job ANS ) ( language ANS languageid0 ) ( language ANS languageid1 ) ( loc ANS locid0 ) ( salary_greater_than ANS num_salary year ) )
what job are there locid0 require a degid0	( answer ( job ANS ) ( loc ANS locid0 ) ( req_deg ANS degid0 ) )
what job pay num_salary are location locid0 and require a degid0	( answer ( job ANS ) ( salary_greater_than ANS num_salary year ) ( loc ANS locid0 ) ( req_deg ANS degid0 ) )
what job are there companyid0	( answer ( job ANS ) ( platform ANS platformid0 ) )
show me all of the areaid0 job locid0	( answer ( area ANS areaid0 ) ( job ANS ) ( loc ANS locid0 ) )
list job platformid0	( answer ( job ANS ) ( platform ANS platformid0 ) )
can show me all the job	( answer ( job ANS ) )
show me the job require year of experience at companyid0	( answer ( job ANS ) ( req_exp ANS year0 ) ( company ANS companyid0 ) )
what job in locid0 only require a degid0 no experience	( answer ( job ANS ) ( loc ANS locid0 ) ( req_deg ANS degid0 ) ( \+ ( req_exp ANS ) ) )
which job pay num_salary that not require a degid0	( answer ( job ANS ) ( salary_greater_than ANS num_salary year ) ( \+ ( req_deg ANS degid0 ) ) )
show me the job with a salary num_salary	( answer ( job ANS ) ( salary_greater_than ANS num_salary year ) )
what job there in languageid0	( answer ( job ANS ) ( language ANS languageid0 ) )
what job there for languageid0 program who dont know languageid1	( answer ( job ANS ) ( language ANS languageid0 ) ( \+ ( language ANS languageid1 ) ) )
what are the job use languageid0 with salary num_salary	( answer ( job ANS ) ( language ANS languageid0 ) ( salary_greater_than ANS num_salary year ) )
show locid0 job require a degid0	( answer ( loc ANS locid0 ) ( job ANS ) ( req_deg ANS degid0 ) )
are there any job in languageid0 that the salary num_salary	( answer ( job ANS ) ( language ANS languageid0 ) ( salary_greater_than ANS num_salary year ) )
what job in locid0 are there that pay at least num_salary year	( answer ( job ANS ) ( loc ANS locid0 ) ( salary_greater_than ANS num_salary year ) )
there be some job out there for a languageid0 titleid0 that think in platformid0 areaid0	( answer ( job ANS ) ( language ANS languageid0 ) ( title ANS titleid0 ) ( platform ANS platformid0 ) ( area ANS areaid0 ) )
are there any job a areaid0 specialist	( answer ( job ANS ) ( area ANS areaid0 ) )
there any job for a areaid0 specialist	( answer ( job ANS ) ( area ANS areaid0 ) )
what job are locid0 that are not at companyid0	( answer ( job ANS ) ( loc ANS locid0 ) ( \+ ( company ANS companyid0 ) ) )
give the job in locid0	( answer ( job ANS ) ( loc ANS locid0 ) )
tell job require degid0	( answer ( job ANS ) ( req_deg ANS degid0 ) )
what job there use languageid0	( answer ( job ANS ) ( language ANS languageid0 ) )
show me job that require year work experience in languageid0	( answer ( job ANS ) ( req_exp ANS year0 ) ( language ANS languageid0 ) )
what job a languageid0 titleid0 find in locid0 on platformid0	( answer ( job ANS ) ( language ANS languageid0 ) ( title ANS titleid0 ) ( loc ANS locid0 ) ( platform ANS platformid0 ) )
give the job use languageid0	( answer ( job ANS ) ( language ANS languageid0 ) )
give some job locid0 on a platformid0 system	( answer ( job ANS ) ( loc ANS locid0 ) ( platform ANS platformid0 ) )
show locid0 job use languageid0 on platformid0	( answer ( loc ANS locid0 ) ( job ANS ) ( language ANS languageid0 ) ( platform ANS platformid0 ) )
what job in locid0 are there pay at least num_salary per year	( answer ( job ANS ) ( loc ANS locid0 ) ( salary_greater_than ANS num_salary year ) )
give me the job use languageid0 dont require platformid0	( answer ( job ANS ) ( language ANS languageid0 ) ( \+ ( platform ANS platformid0 ) ) )
you show me all the job	( answer ( job ANS ) )
what job locid0 are there that pay at least num_salary per year	( answer ( job ANS ) ( loc ANS locid0 ) ( salary_greater_than ANS num_salary year ) )
what out there	( answer ( job ANS ) )
give the job require degid0	( answer ( job ANS ) ( req_deg ANS degid0 ) )
are there any job locid0 require at least a degid0 and know languageid0	( answer ( job ANS ) ( loc ANS locid0 ) ( req_deg ANS degid0 ) ( language ANS languageid0 ) )
