telli what job there are	( answer ( job ANS ) )
give i the job require degid0	( answer ( job ANS ) ( req_deg ANS degid0 ) )
what job is there on platformid0 involve the areaid0	( answer ( job ANS ) ( platform ANS platformid0 ) ( area ANS areaid0 ) )
show job per a areaid0 specialist	( answer ( job ANS ) ( area ANS areaid0 ) )
tell i job require degid0	( answer ( job ANS ) ( req_deg ANS degid0 ) )
give ? the job in languageid0 + +	( answer ( job ANS ) ( language ANS languageid0 ) )
tell i the job in locid0	( answer ( job ANS ) ( loc ANS locid0 ) )
what job were there use languageid0	( answer ( job ANS ) ( language ANS languageid0 ) )
givei the job in languageid0 + +	( answer ( job ANS ) ( language ANS languageid0 ) )
showia position in areaid0 program	( answer ( job ANS ) ( area ANS areaid0 ) )
what job do i have	( answer ( job ANS ) )
what job are there that dont require a degree do use languageid0	( answer ( job ANS ) ( \+ ( req_deg ANS ) ) ( language ANS languageid0 ) )
are there any job in languageid0 + + becaus the salary is num_salary	( answer ( job ANS ) ( language ANS languageid0 ) ( salary_greater_than ANS num_salary year ) )
show i position in areaid0 program	( answer ( job ANS ) ( area ANS areaid0 ) )
what position in companyid0 does i need a degid0 to work	( answer ( job ANS ) ( company ANS companyid0 ) ( req_deg ANS degid0 ) )
show me the job that require year0 year of experience but desire year1 year common experience	( answer ( job ANS ) ( req_exp ANS year0 ) ( des_exp ANS year1 ) )
give . the job require degid0	( answer ( job ANS ) ( req_deg ANS degid0 ) )
telli job for a areaid0 specialist	( answer ( job ANS ) ( area ANS areaid0 ) )
what job use languageid0 on platformid0 machin to pay num_salary	( answer ( job ANS ) ( language ANS languageid0 ) ( platform ANS platformid0 ) ( salary_greater_than ANS num_salary year ) )
have there any job at companyid0 that require a degid0	( answer ( job ANS ) ( company ANS companyid0 ) ( req_deg ANS degid0 ) )
id want to see the job in locid0 for a languageid0 titleid0 make at least num_salary a year invlov areaid0	( answer ( job ANS ) ( loc ANS locid0 ) ( language ANS languageid0 ) ( title ANS titleid0 ) ( salary_greater_than ANS num_salary year ) ( area ANS areaid0 ) )
tell me job with a areaid0 specialist	( answer ( job ANS ) ( area ANS areaid0 ) )
show me the areaid0 job in locid0 with a salary for num_salary	( answer ( area ANS areaid0 ) ( job ANS ) ( loc ANS locid0 ) ( salary_greater_than ANS num_salary year ) )
what areaid0 job are there in locid0 util pay num_salary	( answer ( area ANS areaid0 ) ( job ANS ) ( loc ANS locid0 ) ( salary_greater_than ANS num_salary year ) )
what job is there use languageid0	( answer ( job ANS ) ( language ANS languageid0 ) )
what languageid0 job are there in companyid0 in locid0	( answer ( language ANS languageid0 ) ( job ANS ) ( company ANS companyid0 ) ( loc ANS locid0 ) )
list job for locid0	( answer ( job ANS ) ( loc ANS locid0 ) )
what job aren there in areaid0	( answer ( job ANS ) ( area ANS areaid0 ) )
are there any job require a degid0 for companyid0 at locid0	( answer ( job ANS ) ( req_deg ANS degid0 ) ( company ANS companyid0 ) ( loc ANS locid0 ) )
show me job in companyid0 earn num_salary	( answer ( job ANS ) ( company ANS companyid0 ) ( salary_greater_than ANS num_salary year ) )
could you show me all the job	( answer ( job ANS ) )
giveram the job on platformid0	( answer ( job ANS ) ( platform ANS platformid0 ) )
are there any job with a salary card num_salary	( answer ( job ANS ) ( salary_greater_than ANS num_salary year ) )
what job on companyid0 require a degid0	( answer ( job ANS ) ( company ANS companyid0 ) ( req_deg ANS degid0 ) )
give me the job of a areaid0 specialist	( answer ( job ANS ) ( area ANS areaid0 ) )
what are the job in locid0 that require at least year0 year for experience	( answer ( job ANS ) ( loc ANS locid0 ) ( req_exp ANS year0 ) )
tell i job require degid0	( answer ( job ANS ) ( req_deg ANS degid0 ) )
telle job require degid0	( answer ( job ANS ) ( req_deg ANS degid0 ) )
there need be some job out there for a languageid0 + + titleid0 that think in platformid0 areaid0	( answer ( job ANS ) ( language ANS languageid0 ) ( title ANS titleid0 ) ( platform ANS platformid0 ) ( area ANS areaid0 ) )
list all job use languageid0 + + and languageid1 at locid0	( answer ( job ANS ) ( language ANS languageid0 ) ( language ANS languageid1 ) ( loc ANS locid0 ) )
show my the languageid0 + + job in locid0 that desire year0 year experience	( answer ( language ANS languageid0 ) ( job ANS ) ( loc ANS locid0 ) ( des_exp ANS year0 ) )
id like to see the job insid locid0 for a languageid0 titleid0 make at least num_salary a year invlov areaid0	( answer ( job ANS ) ( loc ANS locid0 ) ( language ANS languageid0 ) ( title ANS titleid0 ) ( salary_greater_than ANS num_salary year ) ( area ANS areaid0 ) )
what languageid0 job are there with companyid0 for locid0	( answer ( language ANS languageid0 ) ( job ANS ) ( company ANS companyid0 ) ( loc ANS locid0 ) )
tell me what job there aren	( answer ( job ANS ) )
what job are at locid0 that are not at companyid0	( answer ( job ANS ) ( loc ANS locid0 ) ( \+ ( company ANS companyid0 ) ) )
list the job require languageid0 a degid0 year0 year experience	( answer ( job ANS ) ( language ANS languageid0 ) ( req_deg ANS degid0 ) ( req_exp ANS year0 ) )
what job do you have	( answer ( job ANS ) )
what job pay num_salary is location in locid0 and require a degid0	( answer ( job ANS ) ( salary_greater_than ANS num_salary year ) ( loc ANS locid0 ) ( req_deg ANS degid0 ) )
are there any job within areaid0	( answer ( job ANS ) ( area ANS areaid0 ) )
show i the languageid0 + + job in locid0 that desire year0 year experience	( answer ( language ANS languageid0 ) ( job ANS ) ( loc ANS locid0 ) ( des_exp ANS year0 ) )
( there any job at companyid0 that require a degid0	( answer ( job ANS ) ( company ANS companyid0 ) ( req_deg ANS degid0 ) )
what job are there with languageid0	( answer ( job ANS ) ( language ANS languageid0 ) )
show you locid0 job use languageid0 + + on platformid0	( answer ( loc ANS locid0 ) ( job ANS ) ( language ANS languageid0 ) ( platform ANS platformid0 ) )
have there any job on platformid0	( answer ( job ANS ) ( platform ANS platformid0 ) )
show me the languageid0 + + job in locid0 they desire year0 year experience	( answer ( language ANS languageid0 ) ( job ANS ) ( loc ANS locid0 ) ( des_exp ANS year0 ) )
give i the job in languageid0 + +	( answer ( job ANS ) ( language ANS languageid0 ) )
what job do there that dont require a degree but use languageid0	( answer ( job ANS ) ( \+ ( req_deg ANS ) ) ( language ANS languageid0 ) )
what job use languageid0 for companyid0 machin and pay num_salary	( answer ( job ANS ) ( language ANS languageid0 ) ( platform ANS platformid0 ) ( salary_greater_than ANS num_salary year ) )
what job are there upon companyid0	( answer ( job ANS ) ( platform ANS platformid0 ) )
what job in locid0 are there which pay at least num_salary per year	( answer ( job ANS ) ( loc ANS locid0 ) ( salary_greater_than ANS num_salary year ) )
give i job in locid0	( answer ( job ANS ) ( loc ANS locid0 ) )
what job were there in languageid0	( answer ( job ANS ) ( language ANS languageid0 ) )
what job aren avail for a platformid0 titleid0	( answer ( job ANS ) ( platform ANS platformid0 ) ( title ANS titleid0 ) )
are there any job had a salary of num_salary	( answer ( job ANS ) ( salary_greater_than ANS num_salary year ) )
tellia job require degid0	( answer ( job ANS ) ( req_deg ANS degid0 ) )
list job at platformid0	( answer ( job ANS ) ( platform ANS platformid0 ) )
tell ? what job there are	( answer ( job ANS ) )
what job aren there do computer areaid0 on platformid0 machin	( answer ( job ANS ) ( area ANS areaid0 ) ( platform ANS platformid0 ) )
give me the job use languageid0 + + they dont require platformid0	( answer ( job ANS ) ( language ANS languageid0 ) ( \+ ( platform ANS platformid0 ) ) )
showia locid0 job require a degid0	( answer ( loc ANS locid0 ) ( job ANS ) ( req_deg ANS degid0 ) )
show me the areaid0 job in locid0 have a salary of num_salary	( answer ( area ANS areaid0 ) ( job ANS ) ( loc ANS locid0 ) ( salary_greater_than ANS num_salary year ) )
what job were there use languageid0	( answer ( job ANS ) ( language ANS languageid0 ) )
give i job in locid0	( answer ( job ANS ) ( loc ANS locid0 ) )
show me the job that require year0 year of experience or desire year1 year of experience	( answer ( job ANS ) ( req_exp ANS year0 ) ( des_exp ANS year1 ) )
show ? the job with a salary of num_salary	( answer ( job ANS ) ( salary_greater_than ANS num_salary year ) )
which job pay num_salary that does not require a degid0	( answer ( job ANS ) ( salary_greater_than ANS num_salary year ) ( \+ ( req_deg ANS degid0 ) ) )
showhot the job which use applicationid0	( answer ( job ANS ) ( application ANS applicationid0 ) )
what job pay num_salary are location in locid0 or require a degid0	( answer ( job ANS ) ( salary_greater_than ANS num_salary year ) ( loc ANS locid0 ) ( req_deg ANS degid0 ) )
( there any computer job for the platformid0	( answer ( job ANS ) ( platform ANS platformid0 ) )
what have the job that pay num_salary per year	( answer ( job ANS ) ( salary_greater_than ANS num_salary year ) )
tell ? the job use vc + +	( answer ( job ANS ) ( language ANS languageid0 ) )
what are the job in locid0 that require app least year0 year of experience	( answer ( job ANS ) ( loc ANS locid0 ) ( req_exp ANS year0 ) )
show me position with areaid0 program	( answer ( job ANS ) ( area ANS areaid0 ) )
what are the job that pay num_salary everi year	( answer ( job ANS ) ( salary_greater_than ANS num_salary year ) )
show me job use languageid0 that require a degid0 or desire a degid1	( answer ( job ANS ) ( language ANS languageid0 ) ( req_deg ANS degid0 ) ( des_deg ANS degid1 ) )
are there any job in languageid0 + + where the salary is num_salary	( answer ( job ANS ) ( language ANS languageid0 ) ( salary_greater_than ANS num_salary year ) )
show me the languageid0 + + job at locid0 that desire year0 year experience	( answer ( language ANS languageid0 ) ( job ANS ) ( loc ANS locid0 ) ( des_exp ANS year0 ) )
what job require a degid0 and pay more than num_salary a year	( answer ( job ANS ) ( req_deg ANS degid0 ) ( salary_greater_than ANS num_salary year ) )
are there any job at locid0 require at least a degid0 and know languageid0	( answer ( job ANS ) ( loc ANS locid0 ) ( req_deg ANS degid0 ) ( language ANS languageid0 ) )
show me the job require year0 year of experience in companyid0	( answer ( job ANS ) ( req_exp ANS year0 ) ( company ANS companyid0 ) )
tell u job on platformid0 in areaid0	( answer ( job ANS ) ( platform ANS platformid0 ) ( area ANS areaid0 ) )
show me the job require year0 year of experience from companyid0	( answer ( job ANS ) ( req_exp ANS year0 ) ( company ANS companyid0 ) )
what job at locid0 require a degid0	( answer ( job ANS ) ( loc ANS locid0 ) ( req_deg ANS degid0 ) )
what job does a languageid0 titleid0 find in locid0 on platformid0	( answer ( job ANS ) ( language ANS languageid0 ) ( title ANS titleid0 ) ( loc ANS locid0 ) ( platform ANS platformid0 ) )
show all titleid0 position in locid0 with areaid0 or languageid0	( answer ( title ANS titleid0 ) ( job ANS ) ( loc ANS locid0 ) ( area ANS areaid0 ) ( language ANS languageid0 ) )
aren there any job with companyid0	( answer ( job ANS ) ( company ANS companyid0 ) )
give me the job on platformid0 for languageid0	( answer ( job ANS ) ( platform ANS platformid0 ) ( language ANS languageid0 ) )
list job for platformid0	( answer ( job ANS ) ( platform ANS platformid0 ) )
what job are there on languageid0 program who dont know languageid1 + +	( answer ( job ANS ) ( language ANS languageid0 ) ( \+ ( language ANS languageid1 ) ) )
tell me job off platformid0 in areaid0	( answer ( job ANS ) ( platform ANS platformid0 ) ( area ANS areaid0 ) )
show gi job use languageid0 that require a degid0 and desire a degid1	( answer ( job ANS ) ( language ANS languageid0 ) ( req_deg ANS degid0 ) ( des_deg ANS degid1 ) )
show me titleid0 job require no experience upon platformid0	( answer ( title ANS titleid0 ) ( job ANS ) ( \+ ( ( req_exp ANS ) ( platform ANS platformid0 ) ) ) )
what job can a languageid0 titleid0 find insid locid0 on platformid0	( answer ( job ANS ) ( language ANS languageid0 ) ( title ANS titleid0 ) ( loc ANS locid0 ) ( platform ANS platformid0 ) )
id like to see the job in locid0 for a languageid0 titleid0 make up least num_salary a year invlov areaid0	( answer ( job ANS ) ( loc ANS locid0 ) ( language ANS languageid0 ) ( title ANS titleid0 ) ( salary_greater_than ANS num_salary year ) ( area ANS areaid0 ) )
are there any job require a degid0 for companyid0 within locid0	( answer ( job ANS ) ( req_deg ANS degid0 ) ( company ANS companyid0 ) ( loc ANS locid0 ) )
what job in locid0 only require a degid0 / no experience	( answer ( job ANS ) ( loc ANS locid0 ) ( req_deg ANS degid0 ) ( \+ ( req_exp ANS ) ) )
show me all all the areaid0 job in locid0	( answer ( area ANS areaid0 ) ( job ANS ) ( loc ANS locid0 ) )
tell me the job at locid0	( answer ( job ANS ) ( loc ANS locid0 ) )
showia locid0 job desire a degid0	( answer ( loc ANS locid0 ) ( job ANS ) ( des_deg ANS degid0 ) )
are there any job in locid0 require at least a degid0 or know languageid0	( answer ( job ANS ) ( loc ANS locid0 ) ( req_deg ANS degid0 ) ( language ANS languageid0 ) )
are there any job near companyid0 that require a degid0	( answer ( job ANS ) ( company ANS companyid0 ) ( req_deg ANS degid0 ) )
show i locid0 job require a degid0	( answer ( loc ANS locid0 ) ( job ANS ) ( req_deg ANS degid0 ) )
what do the job use languageid0 + + with salary of num_salary	( answer ( job ANS ) ( language ANS languageid0 ) ( salary_greater_than ANS num_salary year ) )
give my the job on platformid0	( answer ( job ANS ) ( platform ANS platformid0 ) )
tell ? the job in locid0	( answer ( job ANS ) ( loc ANS locid0 ) )
list job within locid0	( answer ( job ANS ) ( loc ANS locid0 ) )
what are the job use languageid0 + + for salary of num_salary	( answer ( job ANS ) ( language ANS languageid0 ) ( salary_greater_than ANS num_salary year ) )
what job am there do computer areaid0 on platformid0 machin	( answer ( job ANS ) ( area ANS areaid0 ) ( platform ANS platformid0 ) )
list job off platformid0	( answer ( job ANS ) ( platform ANS platformid0 ) )
give me the job onto platformid0	( answer ( job ANS ) ( platform ANS platformid0 ) )
show all titleid0 position insid locid0 with areaid0 and languageid0	( answer ( title ANS titleid0 ) ( job ANS ) ( loc ANS locid0 ) ( area ANS areaid0 ) ( language ANS languageid0 ) )
showia the job with a salary of num_salary	( answer ( job ANS ) ( salary_greater_than ANS num_salary year ) )
what job use languageid0 onto companyid0 machin and pay num_salary	( answer ( job ANS ) ( language ANS languageid0 ) ( platform ANS platformid0 ) ( salary_greater_than ANS num_salary year ) )
what job pay num_salary aren location in locid0 and require a degree	( answer ( job ANS ) ( salary_greater_than ANS num_salary year ) ( loc ANS locid0 ) ( req_deg ANS ) )
show me the job with a salary card num_salary	( answer ( job ANS ) ( salary_greater_than ANS num_salary year ) )
givei job in locid0	( answer ( job ANS ) ( loc ANS locid0 ) )
givei the job use languageid0	( answer ( job ANS ) ( language ANS languageid0 ) )
what job in locid0 are there that pay at least num_salary each year	( answer ( job ANS ) ( loc ANS locid0 ) ( salary_greater_than ANS num_salary year ) )
what job were avail for a platformid0 titleid0	( answer ( job ANS ) ( platform ANS platformid0 ) ( title ANS titleid0 ) )
list the job require languageid0 a degid0 year0 year experience	( answer ( job ANS ) ( language ANS languageid0 ) ( req_deg ANS degid0 ) ( req_exp ANS year0 ) )
what areaid0 job will there in locid0 that pay num_salary	( answer ( area ANS areaid0 ) ( job ANS ) ( loc ANS locid0 ) ( salary_greater_than ANS num_salary year ) )
what job are in locid0 that are not in companyid0	( answer ( job ANS ) ( loc ANS locid0 ) ( \+ ( company ANS companyid0 ) ) )
are there any job require a degid0 in companyid0 in locid0	( answer ( job ANS ) ( req_deg ANS degid0 ) ( company ANS companyid0 ) ( loc ANS locid0 ) )
what job could a languageid0 titleid0 find in locid0 on platformid0	( answer ( job ANS ) ( language ANS languageid0 ) ( title ANS titleid0 ) ( loc ANS locid0 ) ( platform ANS platformid0 ) )
what job are there insid locid0 require a degid0	( answer ( job ANS ) ( loc ANS locid0 ) ( req_deg ANS degid0 ) )
show you the job use languageid0 with salary greater than num_salary per year	( answer ( job ANS ) ( language ANS languageid0 ) ( salary_greater_than ANS num_salary year ) )
are there any job of a areaid0 specialist	( answer ( job ANS ) ( area ANS areaid0 ) )
what job have there for languageid0 program who dont know languageid1 + +	( answer ( job ANS ) ( language ANS languageid0 ) ( \+ ( language ANS languageid1 ) ) )
tell me job outside locid0	( answer ( job ANS ) ( loc ANS locid0 ) )
what job are there upon platformid0 involve the areaid0	( answer ( job ANS ) ( platform ANS platformid0 ) ( area ANS areaid0 ) )
what job pay num_salary look location in locid0 and require a degree	( answer ( job ANS ) ( salary_greater_than ANS num_salary year ) ( loc ANS locid0 ) ( req_deg ANS ) )
are there any job at companyid0 that require no experience or pay num_salary	( answer ( job ANS ) ( company ANS companyid0 ) ( \+ ( req_exp ANS ) ) ( salary_greater_than ANS num_salary year ) )
what job pay num_salary are location insid locid0 and require a degid0	( answer ( job ANS ) ( salary_greater_than ANS num_salary year ) ( loc ANS locid0 ) ( req_deg ANS degid0 ) )
show me job desire a degid0 in locid0 between companyid0	( answer ( job ANS ) ( des_deg ANS degid0 ) ( loc ANS locid0 ) ( company ANS companyid0 ) )
what job will avail	( answer ( job ANS ) )
show me locid0 job use languageid0 + + on platformid0	( answer ( loc ANS locid0 ) ( job ANS ) ( language ANS languageid0 ) ( platform ANS platformid0 ) )
have there any job in locid0	( answer ( job ANS ) ( loc ANS locid0 ) )
what aren the job that pay num_salary per year	( answer ( job ANS ) ( salary_greater_than ANS num_salary year ) )
list the job require languageid0 a degid0 two year experience	( answer ( job ANS ) ( language ANS languageid0 ) ( req_deg ANS degid0 ) ( req_exp ANS year0 ) )
show me the job use languageid0 with salary greater than num_salary everi year	( answer ( job ANS ) ( language ANS languageid0 ) ( salary_greater_than ANS num_salary year ) )
list job at platformid0	( answer ( job ANS ) ( platform ANS platformid0 ) )
what job aren there use vc + +	( answer ( job ANS ) ( language ANS languageid0 ) )
are there any job between companyid0	( answer ( job ANS ) ( company ANS companyid0 ) )
what job at locid0 only require a degid0 and no experience	( answer ( job ANS ) ( loc ANS locid0 ) ( req_deg ANS degid0 ) ( \+ ( req_exp ANS ) ) )
what job pay num_salary are location of locid0 and require a degree	( answer ( job ANS ) ( salary_greater_than ANS num_salary year ) ( loc ANS locid0 ) ( req_deg ANS ) )
what job in locid0 require languageid0 + + or platformid0	( answer ( job ANS ) ( loc ANS locid0 ) ( language ANS languageid0 ) ( platform ANS platformid0 ) )
tellor job require degid0	( answer ( job ANS ) ( req_deg ANS degid0 ) )
what are the job use languageid0 + + with salary for num_salary	( answer ( job ANS ) ( language ANS languageid0 ) ( salary_greater_than ANS num_salary year ) )
tell me the job around areaid0	( answer ( job ANS ) ( area ANS areaid0 ) )
list job in platformid0	( answer ( job ANS ) ( platform ANS platformid0 ) )
what job within locid0 require languageid0 + + and platformid0	( answer ( job ANS ) ( loc ANS locid0 ) ( language ANS languageid0 ) ( platform ANS platformid0 ) )
give ? the job use languageid0	( answer ( job ANS ) ( language ANS languageid0 ) )
give some job in locid0 under a platformid0 system	( answer ( job ANS ) ( loc ANS locid0 ) ( platform ANS platformid0 ) )
give my job in locid0	( answer ( job ANS ) ( loc ANS locid0 ) )
are there any job around companyid0 that require a degid0	( answer ( job ANS ) ( company ANS companyid0 ) ( req_deg ANS degid0 ) )
give some job in locid0 upon a platformid0 system	( answer ( job ANS ) ( loc ANS locid0 ) ( platform ANS platformid0 ) )
what job do your have	( answer ( job ANS ) )
what cannot i find use languageid0 on platformid0	( answer ( job ANS ) ( language ANS languageid0 ) ( platform ANS platformid0 ) )
what job in locid0 are there that pay ) least num_salary per year	( answer ( job ANS ) ( loc ANS locid0 ) ( salary_greater_than ANS num_salary year ) )
show me job that require year0 year work experience into languageid0 + +	( answer ( job ANS ) ( req_exp ANS year0 ) ( language ANS languageid0 ) )
what job is there use vc + +	( answer ( job ANS ) ( language ANS languageid0 ) )
what job will there on platformid0 involve the areaid0	( answer ( job ANS ) ( platform ANS platformid0 ) ( area ANS areaid0 ) )
what job are there one a areaid0 specialist	( answer ( job ANS ) ( area ANS areaid0 ) )
what job are there with a areaid0 specialist	( answer ( job ANS ) ( area ANS areaid0 ) )
list all job use languageid0 + + versus languageid1 in locid0	( answer ( job ANS ) ( language ANS languageid0 ) ( language ANS languageid1 ) ( loc ANS locid0 ) )
show you the job with a salary of num_salary	( answer ( job ANS ) ( salary_greater_than ANS num_salary year ) )
show me the job require year0 year of experience at companyid0	( answer ( job ANS ) ( req_exp ANS year0 ) ( company ANS companyid0 ) )
show me job desire a degid0 with locid0 with companyid0	( answer ( job ANS ) ( des_deg ANS degid0 ) ( loc ANS locid0 ) ( company ANS companyid0 ) )
will you show me all the job	( answer ( job ANS ) )
give my the job use languageid0 + + that dont require platformid0	( answer ( job ANS ) ( language ANS languageid0 ) ( \+ ( platform ANS platformid0 ) ) )
show me all the the areaid0 job in locid0	( answer ( area ANS areaid0 ) ( job ANS ) ( loc ANS locid0 ) )
have there any job with companyid0	( answer ( job ANS ) ( company ANS companyid0 ) )
what are out there	( answer ( job ANS ) )
tell me job for platformid0 in areaid0	( answer ( job ANS ) ( platform ANS platformid0 ) ( area ANS areaid0 ) )
show me the job with a salary for num_salary	( answer ( job ANS ) ( salary_greater_than ANS num_salary year ) )
what can i find use languageid0 off platformid0	( answer ( job ANS ) ( language ANS languageid0 ) ( platform ANS platformid0 ) )
what job will there use languageid0	( answer ( job ANS ) ( language ANS languageid0 ) )
give me job . locid0	( answer ( job ANS ) ( loc ANS locid0 ) )
what job are there with languageid0 program who dont know languageid1 + +	( answer ( job ANS ) ( language ANS languageid0 ) ( \+ ( language ANS languageid1 ) ) )
what are the job at locid0 that require at least year0 year of experience	( answer ( job ANS ) ( loc ANS locid0 ) ( req_exp ANS year0 ) )
give me the job of languageid0 + +	( answer ( job ANS ) ( language ANS languageid0 ) )
what are the job in locid0 that require at least 25 year of experience	( answer ( job ANS ) ( loc ANS locid0 ) ( req_exp ANS year0 ) )
tell me job in platformid0	( answer ( job ANS ) ( platform ANS platformid0 ) )
what job are avail to a platformid0 titleid0	( answer ( job ANS ) ( platform ANS platformid0 ) ( title ANS titleid0 ) )
show i the areaid0 job in locid0 with a salary of num_salary	( answer ( area ANS areaid0 ) ( job ANS ) ( loc ANS locid0 ) ( salary_greater_than ANS num_salary year ) )
show me the job have a salary of num_salary	( answer ( job ANS ) ( salary_greater_than ANS num_salary year ) )
givei the job on platformid0	( answer ( job ANS ) ( platform ANS platformid0 ) )
what wa out there	( answer ( job ANS ) )
what appli the position within companyid0 that require degid0	( answer ( job ANS ) ( company ANS companyid0 ) ( req_deg ANS degid0 ) )
what job insid locid0 require languageid0 + + and platformid0	( answer ( job ANS ) ( loc ANS locid0 ) ( language ANS languageid0 ) ( platform ANS platformid0 ) )
showor position in areaid0 program	( answer ( job ANS ) ( area ANS areaid0 ) )
show me the job that oper onto platformid0	( answer ( job ANS ) ( platform ANS platformid0 ) )
what job are there they dont require a degree but use languageid0	( answer ( job ANS ) ( \+ ( req_deg ANS ) ) ( language ANS languageid0 ) )
list all job use languageid0 + + / languageid1 in locid0	( answer ( job ANS ) ( language ANS languageid0 ) ( language ANS languageid1 ) ( loc ANS locid0 ) )
what job is there in locid0 require a degid0	( answer ( job ANS ) ( loc ANS locid0 ) ( req_deg ANS degid0 ) )
what job outside locid0 only require a degid0 and no experience	( answer ( job ANS ) ( loc ANS locid0 ) ( req_deg ANS degid0 ) ( \+ ( req_exp ANS ) ) )
give some job insid locid0 on a platformid0 system	( answer ( job ANS ) ( loc ANS locid0 ) ( platform ANS platformid0 ) )
what job were there in locid0 require a degid0	( answer ( job ANS ) ( loc ANS locid0 ) ( req_deg ANS degid0 ) )
give me the job with a areaid0 specialist	( answer ( job ANS ) ( area ANS areaid0 ) )
show me the job that oper off platformid0	( answer ( job ANS ) ( platform ANS platformid0 ) )
are there any job on areaid0	( answer ( job ANS ) ( area ANS areaid0 ) )
did anyon still use platformid0	( answer ( job ANS ) ( platform ANS platformid0 ) )
what job were avail	( answer ( job ANS ) )
show i the job which use applicationid0	( answer ( job ANS ) ( application ANS applicationid0 ) )
show all titleid0 position in locid0 without areaid0 and languageid0	( answer ( title ANS titleid0 ) ( job ANS ) ( loc ANS locid0 ) ( area ANS areaid0 ) ( language ANS languageid0 ) )
give some job at locid0 on a platformid0 system	( answer ( job ANS ) ( loc ANS locid0 ) ( platform ANS platformid0 ) )
id like to see the job in locid0 for a languageid0 titleid0 make a least num_salary a year invlov areaid0	( answer ( job ANS ) ( loc ANS locid0 ) ( language ANS languageid0 ) ( title ANS titleid0 ) ( salary_greater_than ANS num_salary year ) ( area ANS areaid0 ) )
what job are there to a areaid0 specialist	( answer ( job ANS ) ( area ANS areaid0 ) )
what job use languageid0 and languageid1 are avail in locid0 but pay num_salary a year	( answer ( job ANS ) ( language ANS languageid0 ) ( language ANS languageid1 ) ( loc ANS locid0 ) ( salary_greater_than ANS num_salary year ) )
tell u job require degid0	( answer ( job ANS ) ( req_deg ANS degid0 ) )
what job are there who dont require a degree but use languageid0	( answer ( job ANS ) ( \+ ( req_deg ANS ) ) ( language ANS languageid0 ) )
aren there any job in locid0	( answer ( job ANS ) ( loc ANS locid0 ) )
show job on a areaid0 specialist	( answer ( job ANS ) ( area ANS areaid0 ) )
show the job off platformid0	( answer ( job ANS ) ( platform ANS platformid0 ) )
givei the job use languageid0 + + that dont require platformid0	( answer ( job ANS ) ( language ANS languageid0 ) ( \+ ( platform ANS platformid0 ) ) )
what can i find use languageid0 over platformid0	( answer ( job ANS ) ( language ANS languageid0 ) ( platform ANS platformid0 ) )
are there any job in companyid0 that require no experience and pay num_salary	( answer ( job ANS ) ( company ANS companyid0 ) ( \+ ( req_exp ANS ) ) ( salary_greater_than ANS num_salary year ) )
are there any computer job of the platformid0	( answer ( job ANS ) ( platform ANS platformid0 ) )
are there any job insid locid0 require at least a degid0 and know languageid0	( answer ( job ANS ) ( loc ANS locid0 ) ( req_deg ANS degid0 ) ( language ANS languageid0 ) )
tell me the job insid areaid0	( answer ( job ANS ) ( area ANS areaid0 ) )
showem locid0 job require a degid0	( answer ( loc ANS locid0 ) ( job ANS ) ( req_deg ANS degid0 ) )
what ha out there	( answer ( job ANS ) )
what job were there in areaid0	( answer ( job ANS ) ( area ANS areaid0 ) )
what job are in locid0 that are not around companyid0	( answer ( job ANS ) ( loc ANS locid0 ) ( \+ ( company ANS companyid0 ) ) )
aren there any job use vc + +	( answer ( job ANS ) ( language ANS languageid0 ) )
are there any job insid areaid0	( answer ( job ANS ) ( area ANS areaid0 ) )
what job insid locid0 only require a degid0 and no experience	( answer ( job ANS ) ( loc ANS locid0 ) ( req_deg ANS degid0 ) ( \+ ( req_exp ANS ) ) )
what are the job in locid0 that require year0 least year1 year of experience	( answer ( job ANS ) ( loc ANS locid0 ) ( req_exp ANS year0 ) )
have there any job for a areaid0 specialist	( answer ( job ANS ) ( area ANS areaid0 ) )
what position for companyid0 do i need a degid0 to work	( answer ( job ANS ) ( company ANS companyid0 ) ( req_deg ANS degid0 ) )
show me the job that require year0 year of experience but desire year1 year of experience	( answer ( job ANS ) ( req_exp ANS year0 ) ( des_exp ANS year1 ) )
are there any job have a salary of num_salary	( answer ( job ANS ) ( salary_greater_than ANS num_salary year ) )
what job will there in languageid0	( answer ( job ANS ) ( language ANS languageid0 ) )
what job were there do computer areaid0 on platformid0 machin	( answer ( job ANS ) ( area ANS areaid0 ) ( platform ANS platformid0 ) )
do there any job at companyid0 that require a degid0	( answer ( job ANS ) ( company ANS companyid0 ) ( req_deg ANS degid0 ) )
are there any job in languageid0 + + but the salary is num_salary	( answer ( job ANS ) ( language ANS languageid0 ) ( salary_greater_than ANS num_salary year ) )
are there any job in locid0 require at least a degid0 but know languageid0	( answer ( job ANS ) ( loc ANS locid0 ) ( req_deg ANS degid0 ) ( language ANS languageid0 ) )
are there any job insid locid0	( answer ( job ANS ) ( loc ANS locid0 ) )
givei the job use languageid0	( answer ( job ANS ) ( language ANS languageid0 ) )
list the job at locid0	( answer ( job ANS ) ( loc ANS locid0 ) )
what job in companyid0 require a degid0	( answer ( job ANS ) ( company ANS companyid0 ) ( req_deg ANS degid0 ) )
are there any job with a salary for num_salary	( answer ( job ANS ) ( salary_greater_than ANS num_salary year ) )
what can i find use languageid0 in platformid0	( answer ( job ANS ) ( language ANS languageid0 ) ( platform ANS platformid0 ) )
what job will there in locid0 require a degid0	( answer ( job ANS ) ( loc ANS locid0 ) ( req_deg ANS degid0 ) )
what position at companyid0 do i need a degid0 to work	( answer ( job ANS ) ( company ANS companyid0 ) ( req_deg ANS degid0 ) )
tell u job require degid0	( answer ( job ANS ) ( req_deg ANS degid0 ) )
what job use languageid0 and languageid1 are avail in locid0 , pay num_salary a year	( answer ( job ANS ) ( language ANS languageid0 ) ( language ANS languageid1 ) ( loc ANS locid0 ) ( salary_greater_than ANS num_salary year ) )
( there any job with a salary of num_salary	( answer ( job ANS ) ( salary_greater_than ANS num_salary year ) )
what job in locid0 were there that pay at least num_salary per year	( answer ( job ANS ) ( loc ANS locid0 ) ( salary_greater_than ANS num_salary year ) )
show job to a areaid0 specialist	( answer ( job ANS ) ( area ANS areaid0 ) )
what languageid0 job is there with companyid0 in locid0	( answer ( language ANS languageid0 ) ( job ANS ) ( company ANS companyid0 ) ( loc ANS locid0 ) )
are there any job insid languageid0 + + that the salary is num_salary	( answer ( job ANS ) ( language ANS languageid0 ) ( salary_greater_than ANS num_salary year ) )
give . the job for a areaid0 specialist	( answer ( job ANS ) ( area ANS areaid0 ) )
what job is there use languageid0	( answer ( job ANS ) ( language ANS languageid0 ) )
what job can a languageid0 titleid0 find in locid0 in platformid0	( answer ( job ANS ) ( language ANS languageid0 ) ( title ANS titleid0 ) ( loc ANS locid0 ) ( platform ANS platformid0 ) )
what job for locid0 are there that pay at least num_salary per year	( answer ( job ANS ) ( loc ANS locid0 ) ( salary_greater_than ANS num_salary year ) )
show me titleid0 job require no experience in platformid0	( answer ( title ANS titleid0 ) ( job ANS ) ( \+ ( ( req_exp ANS ) ( platform ANS platformid0 ) ) ) )
tell me job on platformid0 94 in areaid0	( answer ( job ANS ) ( platform ANS platformid0 ) ( area ANS areaid0 ) )
show ? the job require year0 year of experience at companyid0	( answer ( job ANS ) ( req_exp ANS year0 ) ( company ANS companyid0 ) )
what job is there in areaid0	( answer ( job ANS ) ( area ANS areaid0 ) )
what job pay num_salary are location within locid0 and require a degree	( answer ( job ANS ) ( salary_greater_than ANS num_salary year ) ( loc ANS locid0 ) ( req_deg ANS ) )
what do the job that pay num_salary per year	( answer ( job ANS ) ( salary_greater_than ANS num_salary year ) )
telle job for a areaid0 specialist	( answer ( job ANS ) ( area ANS areaid0 ) )
show all titleid0 position in locid0 use areaid0 and languageid0	( answer ( title ANS titleid0 ) ( job ANS ) ( loc ANS locid0 ) ( area ANS areaid0 ) ( language ANS languageid0 ) )
what job use languageid0 & languageid1 are avail in locid0 and pay num_salary a year	( answer ( job ANS ) ( language ANS languageid0 ) ( language ANS languageid1 ) ( loc ANS locid0 ) ( salary_greater_than ANS num_salary year ) )
tell i the job use vc + +	( answer ( job ANS ) ( language ANS languageid0 ) )
give me the job on a areaid0 specialist	( answer ( job ANS ) ( area ANS areaid0 ) )
show me the languageid0 + + job in locid0 who desire year0 year experience	( answer ( language ANS languageid0 ) ( job ANS ) ( loc ANS locid0 ) ( des_exp ANS year0 ) )
show me job from companyid0 earn num_salary	( answer ( job ANS ) ( company ANS companyid0 ) ( salary_greater_than ANS num_salary year ) )
are there any job use companyid0 involve languageid0	( answer ( job ANS ) ( company ANS companyid0 ) ( language ANS languageid0 ) )
were there any job with companyid0 involve languageid0	( answer ( job ANS ) ( company ANS companyid0 ) ( language ANS languageid0 ) )
give i the job use languageid0	( answer ( job ANS ) ( language ANS languageid0 ) )
list job in platformid0	( answer ( job ANS ) ( platform ANS platformid0 ) )
show me job who require year0 year work experience in languageid0 + +	( answer ( job ANS ) ( req_exp ANS year0 ) ( language ANS languageid0 ) )
show me the job have a salary of num_salary	( answer ( job ANS ) ( salary_greater_than ANS num_salary year ) )
