what job are avail	( answer ( job ANS ) )
what role do you have	( answer ( job ANS ) )
ask me what job there are	( answer ( job ANS ) )
what job do you have	( answer ( job ANS ) )
can you show me all the job	( answer ( job ANS ) )
tell me the employ in locid0	( answer ( job ANS ) ( loc ANS locid0 ) )
get me job in locid0	( answer ( job ANS ) ( loc ANS locid0 ) )
make me job in locid0	( answer ( job ANS ) ( loc ANS locid0 ) )
take me job in locid0	( answer ( job ANS ) ( loc ANS locid0 ) )
list job in locid0	( answer ( job ANS ) ( loc ANS locid0 ) )
get me the job use languageid0	( answer ( job ANS ) ( language ANS languageid0 ) )
what job are there use languageid0	( answer ( job ANS ) ( language ANS languageid0 ) )
give me the job use languageid0	( answer ( job ANS ) ( language ANS languageid0 ) )
what job are there use languageid0	( answer ( job ANS ) ( language ANS languageid0 ) )
list the job util languageid0	( answer ( job ANS ) ( language ANS languageid0 ) )
what job are there util languageid0	( answer ( job ANS ) ( language ANS languageid0 ) )
what sort of job could i find for an old languageid0 titleid0	( answer ( job ANS ) ( language ANS languageid0 ) ( title ANS titleid0 ) )
what kind of job could i found for an old languageid0 titleid0	( answer ( job ANS ) ( language ANS languageid0 ) ( title ANS titleid0 ) )
what job are present in areaid0	( answer ( job ANS ) ( area ANS areaid0 ) )
are there any job for a areaid0 specialist	( answer ( job ANS ) ( area ANS areaid0 ) )
what job are avail for a platformid0 titleid0	( answer ( job ANS ) ( platform ANS platformid0 ) ( title ANS titleid0 ) )
show me the job require year0 year of experience at companyid0	( answer ( job ANS ) ( req_exp ANS year0 ) ( company ANS companyid0 ) )
show me the job require year0 year of experience at companyid0	( answer ( job ANS ) ( req_exp ANS year0 ) ( company ANS companyid0 ) )
give me the job util languageid0 that dont require platformid0	( answer ( job ANS ) ( language ANS languageid0 ) ( \+ ( platform ANS platformid0 ) ) )
give me the job use languageid0 that dont require platformid0	( answer ( job ANS ) ( language ANS languageid0 ) ( \+ ( platform ANS platformid0 ) ) )
show me the job which use applicationid0	( answer ( job ANS ) ( application ANS applicationid0 ) )
show me the job which util applicationid0	( answer ( job ANS ) ( application ANS applicationid0 ) )
show me job at companyid0 earn num_salary	( answer ( job ANS ) ( company ANS companyid0 ) ( salary_greater_than ANS num_salary year ) )
give me job at companyid0 earn num_salary	( answer ( job ANS ) ( company ANS companyid0 ) ( salary_greater_than ANS num_salary year ) )
what job pay num_salary are situat in locid0 and require a degree	( answer ( job ANS ) ( salary_greater_than ANS num_salary year ) ( loc ANS locid0 ) ( req_deg ANS ) )
what job paid num_salary are location in locid0 and require a degree	( answer ( job ANS ) ( salary_greater_than ANS num_salary year ) ( loc ANS locid0 ) ( req_deg ANS ) )
show me the job which util applicationid0	( answer ( job ANS ) ( application ANS applicationid0 ) )
make some job in locid0 on a platformid0 system	( answer ( job ANS ) ( loc ANS locid0 ) ( platform ANS platformid0 ) )
what job in locid0 require languageid0 and platformid0	( answer ( job ANS ) ( loc ANS locid0 ) ( language ANS languageid0 ) ( platform ANS platformid0 ) )
are there any position with companyid0	( answer ( job ANS ) ( company ANS companyid0 ) )
what are the job util languageid0 with salary of num_salary	( answer ( job ANS ) ( language ANS languageid0 ) ( salary_greater_than ANS num_salary year ) )
are present any job in languageid0 that the salary is num_salary	( answer ( job ANS ) ( language ANS languageid0 ) ( salary_greater_than ANS num_salary year ) )
what job pay num_salary are location in locid0 and require a degid0	( answer ( job ANS ) ( salary_greater_than ANS num_salary year ) ( loc ANS locid0 ) ( req_deg ANS degid0 ) )
what are the job that paid num_salary per year	( answer ( job ANS ) ( salary_greater_than ANS num_salary year ) )
what are the job in locid0 that require at least year0 year of experience	( answer ( job ANS ) ( loc ANS locid0 ) ( req_exp ANS year0 ) )
what are the job in locid0 that need at least year0 year of experience	( answer ( job ANS ) ( loc ANS locid0 ) ( req_exp ANS year0 ) )
are there any job at companyid0 that require a degid0	( answer ( job ANS ) ( company ANS companyid0 ) ( req_deg ANS degid0 ) )
show me the languageid0 job in locid0 that desire year0 year experience	( answer ( language ANS languageid0 ) ( job ANS ) ( loc ANS locid0 ) ( des_exp ANS year0 ) )
what job in locid0 require a degid0	( answer ( job ANS ) ( loc ANS locid0 ) ( req_deg ANS degid0 ) )
tell me job require degid0	( answer ( job ANS ) ( req_deg ANS degid0 ) )
give me the job require degid0	( answer ( job ANS ) ( req_deg ANS degid0 ) )
make me the job on platformid0 in languageid0	( answer ( job ANS ) ( platform ANS platformid0 ) ( language ANS languageid0 ) )
get me the job on platformid0 in languageid0	( answer ( job ANS ) ( platform ANS platformid0 ) ( language ANS languageid0 ) )
what job are there do computer areaid0 on platformid0 machin	( answer ( job ANS ) ( area ANS areaid0 ) ( platform ANS platformid0 ) )
what job are there conduct computer areaid0 on platformid0 machin	( answer ( job ANS ) ( area ANS areaid0 ) ( platform ANS platformid0 ) )
what job are there perform computer areaid0 on platformid0 machin	( answer ( job ANS ) ( area ANS areaid0 ) ( platform ANS platformid0 ) )
show me job that require year0 year work experience in languageid0	( answer ( job ANS ) ( req_exp ANS year0 ) ( language ANS languageid0 ) )
are there any job with companyid0 involve languageid0	( answer ( job ANS ) ( company ANS companyid0 ) ( language ANS languageid0 ) )
show me the job that require year0 year of experience but desire year1 year of experience	( answer ( job ANS ) ( req_exp ANS year0 ) ( des_exp ANS year1 ) )
show me the job that require year0 year of experience but desire year1 year of experience	( answer ( job ANS ) ( req_exp ANS year0 ) ( des_exp ANS year1 ) )
show me all of the areaid0 job in locid0	( answer ( area ANS areaid0 ) ( job ANS ) ( loc ANS locid0 ) )
show me all of the areaid0 employ in locid0	( answer ( area ANS areaid0 ) ( job ANS ) ( loc ANS locid0 ) )
are there any job require a degid0 for companyid0 in locid0	( answer ( job ANS ) ( req_deg ANS degid0 ) ( company ANS companyid0 ) ( loc ANS locid0 ) )
what languageid0 job are there with companyid0 in locid0	( answer ( language ANS languageid0 ) ( job ANS ) ( company ANS companyid0 ) ( loc ANS locid0 ) )
which job pay num_salary that do not require a degid0	( answer ( job ANS ) ( salary_greater_than ANS num_salary year ) ( \+ ( req_deg ANS degid0 ) ) )
show me the areaid0 job in locid0 with a salary of num_salary	( answer ( area ANS areaid0 ) ( job ANS ) ( loc ANS locid0 ) ( salary_greater_than ANS num_salary year ) )
show me the areaid0 career in locid0 with a salary of num_salary	( answer ( area ANS areaid0 ) ( job ANS ) ( loc ANS locid0 ) ( salary_greater_than ANS num_salary year ) )
show me titleid0 job need no experience on platformid0	( answer ( title ANS titleid0 ) ( job ANS ) ( \+ ( ( req_exp ANS ) ( platform ANS platformid0 ) ) ) )
what job can a languageid0 titleid0 get in locid0 on platformid0	( answer ( job ANS ) ( language ANS languageid0 ) ( title ANS titleid0 ) ( loc ANS locid0 ) ( platform ANS platformid0 ) )
are there any job at companyid0 that require a degid0	( answer ( job ANS ) ( company ANS companyid0 ) ( req_deg ANS degid0 ) )
what are the position within companyid0 that require degid0	( answer ( job ANS ) ( company ANS companyid0 ) ( req_deg ANS degid0 ) )
are there any job at companyid0 that need a degid0	( answer ( job ANS ) ( company ANS companyid0 ) ( req_deg ANS degid0 ) )
what areaid0 position require only a degid0	( answer ( area ANS areaid0 ) ( job ANS ) ( req_deg ANS degid0 ) )
what job in locid0 are there that pay at least num_salary per year	( answer ( job ANS ) ( loc ANS locid0 ) ( salary_greater_than ANS num_salary year ) )
what job util languageid0 on platformid0 machin and pay num_salary	( answer ( job ANS ) ( language ANS languageid0 ) ( platform ANS platformid0 ) ( salary_greater_than ANS num_salary year ) )
what can i found use languageid0 on platformid0	( answer ( job ANS ) ( language ANS languageid0 ) ( platform ANS platformid0 ) )
what job are there for languageid0 program who dont knew languageid1	( answer ( job ANS ) ( language ANS languageid0 ) ( \+ ( language ANS languageid1 ) ) )
what job use languageid0 and languageid1 are avail in locid0 and pay num_salary a year	( answer ( job ANS ) ( language ANS languageid0 ) ( language ANS languageid1 ) ( loc ANS locid0 ) ( salary_greater_than ANS num_salary year ) )
what job use languageid0 and languageid1 are avail in locid0 and pay num_salary a year	( answer ( job ANS ) ( language ANS languageid0 ) ( language ANS languageid1 ) ( loc ANS locid0 ) ( salary_greater_than ANS num_salary year ) )
what job need a degid0 and pay more than num_salary per year	( answer ( job ANS ) ( req_deg ANS degid0 ) ( salary_greater_than ANS num_salary year ) )
list all job use languageid0 and languageid1 in locid0	( answer ( job ANS ) ( language ANS languageid0 ) ( language ANS languageid1 ) ( loc ANS locid0 ) )
list all job util languageid0 and languageid1 in locid0	( answer ( job ANS ) ( language ANS languageid0 ) ( language ANS languageid1 ) ( loc ANS locid0 ) )
tell me job desire a degid0 in locid0 with companyid0	( answer ( job ANS ) ( des_deg ANS degid0 ) ( loc ANS locid0 ) ( company ANS companyid0 ) )
give me job desire a degid0 in locid0 with companyid0	( answer ( job ANS ) ( des_deg ANS degid0 ) ( loc ANS locid0 ) ( company ANS companyid0 ) )
id like to saw the job in locid0 for a languageid0 titleid0 make at least num_salary a year invlov areaid0	( answer ( job ANS ) ( loc ANS locid0 ) ( language ANS languageid0 ) ( title ANS titleid0 ) ( salary_greater_than ANS num_salary year ) ( area ANS areaid0 ) )
are there any job in locid0 require at least a degid0 and know languageid0	( answer ( job ANS ) ( loc ANS locid0 ) ( req_deg ANS degid0 ) ( language ANS languageid0 ) )
show me locid0 job util languageid0 on platformid0	( answer ( loc ANS locid0 ) ( job ANS ) ( language ANS languageid0 ) ( platform ANS platformid0 ) )
show me locid0 job use languageid0 on platformid0	( answer ( loc ANS locid0 ) ( job ANS ) ( language ANS languageid0 ) ( platform ANS platformid0 ) )
give me locid0 job desire a degid0	( answer ( loc ANS locid0 ) ( job ANS ) ( des_deg ANS degid0 ) )
there must be some job out there for a languageid0 titleid0 that think in platformid0 areaid0	( answer ( job ANS ) ( language ANS languageid0 ) ( title ANS titleid0 ) ( platform ANS platformid0 ) ( area ANS areaid0 ) )
there must be some job out there for a languageid0 titleid0 that think in platformid0 areaid0	( answer ( job ANS ) ( language ANS languageid0 ) ( title ANS titleid0 ) ( platform ANS platformid0 ) ( area ANS areaid0 ) )
