telli what job there are	job ( ANS )
give i the job requir degid0	job ( ANS ) , req_deg ( ANS , degid0 )
what job is there on platformid0 involv the areaid0	job ( ANS ) , platform ( ANS , platformid0 ) , area ( ANS , areaid0 )
tell i job requir degid0	job ( ANS ) , req_deg ( ANS , degid0 )
give ? the job in languageid0 + +	job ( ANS ) , language ( ANS , languageid0 )
what kind of job are avail for languageid0 titleid0 within locid0	job ( ANS ) , language ( ANS , languageid0 ) , title ( ANS , titleid0 ) , loc ( ANS , locid0 )
showia titleid0 job requir no experi on platformid0	title ( ANS , titleid0 ) , job ( ANS ) , \+ ( req_exp ( ANS ) , platform ( ANS , platformid0 ) )
what job were there use languageid0	job ( ANS ) , language ( ANS , languageid0 )
givei the job in languageid0 + +	job ( ANS ) , language ( ANS , languageid0 )
showia posit in areaid0 program	job ( ANS ) , area ( ANS , areaid0 )
what job do i have	job ( ANS )
what job are there that dont requir a degre do use languageid0	job ( ANS ) , \+ req_deg ( ANS ) , language ( ANS , languageid0 )
were there ani job use vc + +	job ( ANS ) , language ( ANS , languageid0 )
show i posit in areaid0 program	job ( ANS ) , area ( ANS , areaid0 )
show me the job that requir year0 year of experi but desir year1 year common experi	job ( ANS ) , req_exp ( ANS , year0 ) , des_exp ( ANS , year1 )
show me job realli requir year0 year work experi in languageid0 + +	job ( ANS ) , req_exp ( ANS , year0 ) , language ( ANS , languageid0 )
telli job for a areaid0 specialist	job ( ANS ) , area ( ANS , areaid0 )
what job is avail	job ( ANS )
what kind of job can i find for an old languageid0 titleid0	job ( ANS ) , language ( ANS , languageid0 ) , title ( ANS , titleid0 )
what job use languageid0 on platformid0 machin to pay num_salary	job ( ANS ) , language ( ANS , languageid0 ) , platform ( ANS , platformid0 ) , salary_greater_than ( ANS , num_salary , year )
show me the areaid0 job at locid0 with a salari of num_salary	area ( ANS , areaid0 ) , job ( ANS ) , loc ( ANS , locid0 ) , salary_greater_than ( ANS , num_salary , year )
show me the areaid0 job in locid0 with a salari for num_salary	area ( ANS , areaid0 ) , job ( ANS ) , loc ( ANS , locid0 ) , salary_greater_than ( ANS , num_salary , year )
what areaid0 job are there in locid0 util pay num_salary	area ( ANS , areaid0 ) , job ( ANS ) , loc ( ANS , locid0 ) , salary_greater_than ( ANS , num_salary , year )
what job is there use languageid0	job ( ANS ) , language ( ANS , languageid0 )
what languageid0 job are there in companyid0 in locid0	language ( ANS , languageid0 ) , job ( ANS ) , company ( ANS , companyid0 ) , loc ( ANS , locid0 )
list job for locid0	job ( ANS ) , loc ( ANS , locid0 )
is there ani job use vc + +	job ( ANS ) , language ( ANS , languageid0 )
what job are around locid0 that are not at companyid0	job ( ANS ) , loc ( ANS , locid0 ) , \+ company ( ANS , companyid0 )
show me job in companyid0 earn num_salary	job ( ANS ) , company ( ANS , companyid0 ) , salary_greater_than ( ANS , num_salary , year )
show i job at companyid0 earn num_salary	job ( ANS ) , company ( ANS , companyid0 ) , salary_greater_than ( ANS , num_salary , year )
show ? the job that oper on platformid0	job ( ANS ) , platform ( ANS , platformid0 )
give me the job of a areaid0 specialist	job ( ANS ) , area ( ANS , areaid0 )
give me the job onto platformid0	job ( ANS ) , platform ( ANS , platformid0 )
tell i job requir degid0	job ( ANS ) , req_deg ( ANS , degid0 )
show me job use languageid0 that requir a degid0 they desir a degid1	job ( ANS ) , language ( ANS , languageid0 ) , req_deg ( ANS , degid0 ) , des_deg ( ANS , degid1 )
show . the job that requir year0 year of experi but desir year1 year of experi	job ( ANS ) , req_exp ( ANS , year0 ) , des_exp ( ANS , year1 )
what program job aren there in locid0 that use languageid0	job ( ANS ) , loc ( ANS , locid0 ) , language ( ANS , languageid0 )
telle job requir degid0	job ( ANS ) , req_deg ( ANS , degid0 )
there need be some job out there for a languageid0 + + titleid0 that think in platformid0 areaid0	job ( ANS ) , language ( ANS , languageid0 ) , title ( ANS , titleid0 ) , platform ( ANS , platformid0 ) , area ( ANS , areaid0 )
list all job use languageid0 + + and languageid1 at locid0	job ( ANS ) , language ( ANS , languageid0 ) , language ( ANS , languageid1 ) , loc ( ANS , locid0 )
what program job are there outsid locid0 that use languageid0	job ( ANS ) , loc ( ANS , locid0 ) , language ( ANS , languageid0 )
show my the languageid0 + + job in locid0 that desir year0 year experi	language ( ANS , languageid0 ) , job ( ANS ) , loc ( ANS , locid0 ) , des_exp ( ANS , year0 )
what languageid0 job are there with companyid0 for locid0	language ( ANS , languageid0 ) , job ( ANS ) , company ( ANS , companyid0 ) , loc ( ANS , locid0 )
what job is there in languageid0	job ( ANS ) , language ( ANS , languageid0 )
give my the job for a areaid0 specialist	job ( ANS ) , area ( ANS , areaid0 )
show i the languageid0 + + job in locid0 that desir year0 year experi	language ( ANS , languageid0 ) , job ( ANS ) , loc ( ANS , locid0 ) , des_exp ( ANS , year0 )
show you locid0 job use languageid0 + + on platformid0	loc ( ANS , locid0 ) , job ( ANS ) , language ( ANS , languageid0 ) , platform ( ANS , platformid0 )
show me the languageid0 + + job in locid0 they desir year0 year experi	language ( ANS , languageid0 ) , job ( ANS ) , loc ( ANS , locid0 ) , des_exp ( ANS , year0 )
give i the job in languageid0 + +	job ( ANS ) , language ( ANS , languageid0 )
are there ani job that do not requir five year of experi	job ( ANS ) , \+ req_exp ( ANS , year0 )
what job do there that dont requir a degre but use languageid0	job ( ANS ) , \+ req_deg ( ANS ) , language ( ANS , languageid0 )
what job use languageid0 for companyid0 machin and pay num_salary	job ( ANS ) , language ( ANS , languageid0 ) , platform ( ANS , platformid0 ) , salary_greater_than ( ANS , num_salary , year )
what job are there upon companyid0	job ( ANS ) , platform ( ANS , platformid0 )
tell i job on platformid0	job ( ANS ) , platform ( ANS , platformid0 )
give i the job on platformid0	job ( ANS ) , platform ( ANS , platformid0 )
give i job in locid0	job ( ANS ) , loc ( ANS , locid0 )
what job aren avail for a platformid0 titleid0	job ( ANS ) , platform ( ANS , platformid0 ) , title ( ANS , titleid0 )
give me the job for platformid0	job ( ANS ) , platform ( ANS , platformid0 )
are there ani job had a salari of num_salary	job ( ANS ) , salary_greater_than ( ANS , num_salary , year )
tellia job requir degid0	job ( ANS ) , req_deg ( ANS , degid0 )
what job are avail with a platformid0 titleid0	job ( ANS ) , platform ( ANS , platformid0 ) , title ( ANS , titleid0 )
tell ? what job there are	job ( ANS )
can you show me languageid0 job with num_salary salari without areaid0 and applicationid0	job ( ANS ) , language ( ANS , languageid0 ) , salary_greater_than ( ANS , num_salary , year ) , area ( ANS , areaid0 ) , application ( ANS , applicationid0 )
what job aren there do comput areaid0 on platformid0 machin	job ( ANS ) , area ( ANS , areaid0 ) , platform ( ANS , platformid0 )
give me the job use languageid0 + + they dont requir platformid0	job ( ANS ) , language ( ANS , languageid0 ) , \+ platform ( ANS , platformid0 )
showia locid0 job requir a degid0	loc ( ANS , locid0 ) , job ( ANS ) , req_deg ( ANS , degid0 )
show me the areaid0 job in locid0 have a salari of num_salary	area ( ANS , areaid0 ) , job ( ANS ) , loc ( ANS , locid0 ) , salary_greater_than ( ANS , num_salary , year )
what job were there use languageid0	job ( ANS ) , language ( ANS , languageid0 )
give i job in locid0	job ( ANS ) , loc ( ANS , locid0 )
show me the job that requir year0 year of experi or desir year1 year of experi	job ( ANS ) , req_exp ( ANS , year0 ) , des_exp ( ANS , year1 )
can you show i all the job	job ( ANS )
what job requir a degid0 that pay more than num_salary per year	job ( ANS ) , req_deg ( ANS , degid0 ) , salary_greater_than ( ANS , num_salary , year )
give me the job onto platformid0 in languageid0	job ( ANS ) , platform ( ANS , platformid0 ) , language ( ANS , languageid0 )
which job pay num_salary that doe not requir a degid0	job ( ANS ) , salary_greater_than ( ANS , num_salary , year ) , \+ req_deg ( ANS , degid0 )
what kind of job are avail for languageid0 titleid0 for locid0	job ( ANS ) , language ( ANS , languageid0 ) , title ( ANS , titleid0 ) , loc ( ANS , locid0 )
what job pay num_salary are locat in locid0 or requir a degid0	job ( ANS ) , salary_greater_than ( ANS , num_salary , year ) , loc ( ANS , locid0 ) , req_deg ( ANS , degid0 )
what are the posit outsid companyid0 that requir degid0	job ( ANS ) , company ( ANS , companyid0 ) , req_deg ( ANS , degid0 )
( there ani comput job for the platformid0	job ( ANS ) , platform ( ANS , platformid0 )
can your show me all the job	job ( ANS )
tell ? the job use vc + +	job ( ANS ) , language ( ANS , languageid0 )
what are the job in locid0 that requir app least year0 year of experi	job ( ANS ) , loc ( ANS , locid0 ) , req_exp ( ANS , year0 )
show me posit with areaid0 program	job ( ANS ) , area ( ANS , areaid0 )
show me job use languageid0 that requir a degid0 or desir a degid1	job ( ANS ) , language ( ANS , languageid0 ) , req_deg ( ANS , degid0 ) , des_deg ( ANS , degid1 )
give me the job use languageid0 + + chunk dont requir platformid0	job ( ANS ) , language ( ANS , languageid0 ) , \+ platform ( ANS , platformid0 )
what program job are there in locid0 base use languageid0	job ( ANS ) , loc ( ANS , locid0 ) , language ( ANS , languageid0 )
show me the languageid0 + + job at locid0 that desir year0 year experi	language ( ANS , languageid0 ) , job ( ANS ) , loc ( ANS , locid0 ) , des_exp ( ANS , year0 )
show me job that requir year0 year work experi with languageid0 + +	job ( ANS ) , req_exp ( ANS , year0 ) , language ( ANS , languageid0 )
showia job that requir year0 year work experi in languageid0 + +	job ( ANS ) , req_exp ( ANS , year0 ) , language ( ANS , languageid0 )
list all job use languageid0 + + and languageid1 for locid0	job ( ANS ) , language ( ANS , languageid0 ) , language ( ANS , languageid1 ) , loc ( ANS , locid0 )
are there ani job at locid0 requir at least a degid0 and know languageid0	job ( ANS ) , loc ( ANS , locid0 ) , req_deg ( ANS , degid0 ) , language ( ANS , languageid0 )
tell me job off platformid0	job ( ANS ) , platform ( ANS , platformid0 )
show me the job requir year0 year of experi in companyid0	job ( ANS ) , req_exp ( ANS , year0 ) , company ( ANS , companyid0 )
do ani job exist program on companyid0 on platformid0	job ( ANS ) , company ( ANS , companyid0 ) , platform ( ANS , platformid0 )
tell us job on platformid0 in areaid0	job ( ANS ) , platform ( ANS , platformid0 ) , area ( ANS , areaid0 )
what job are there for companyid0	job ( ANS ) , platform ( ANS , platformid0 )
show me the job requir year0 year of experi from companyid0	job ( ANS ) , req_exp ( ANS , year0 ) , company ( ANS , companyid0 )
what job doe a languageid0 titleid0 find in locid0 on platformid0	job ( ANS ) , language ( ANS , languageid0 ) , title ( ANS , titleid0 ) , loc ( ANS , locid0 ) , platform ( ANS , platformid0 )
show all titleid0 posit in locid0 with areaid0 or languageid0	title ( ANS , titleid0 ) , job ( ANS ) , loc ( ANS , locid0 ) , area ( ANS , areaid0 ) , language ( ANS , languageid0 )
show the job in platformid0	job ( ANS ) , platform ( ANS , platformid0 )
aren there ani job with companyid0	job ( ANS ) , company ( ANS , companyid0 )
what job insid locid0 requir a degid0	job ( ANS ) , loc ( ANS , locid0 ) , req_deg ( ANS , degid0 )
list job for platformid0	job ( ANS ) , platform ( ANS , platformid0 )
what job are there on languageid0 program who dont know languageid1 + +	job ( ANS ) , language ( ANS , languageid0 ) , \+ language ( ANS , languageid1 )
show i all of the areaid0 job in locid0	area ( ANS , areaid0 ) , job ( ANS ) , loc ( ANS , locid0 )
tell me job off platformid0 in areaid0	job ( ANS ) , platform ( ANS , platformid0 ) , area ( ANS , areaid0 )
give me the job around locid0	job ( ANS ) , loc ( ANS , locid0 )
do there ani job requir a degid0 for companyid0 in locid0	job ( ANS ) , req_deg ( ANS , degid0 ) , company ( ANS , companyid0 ) , loc ( ANS , locid0 )
what program job are there in locid0 which use languageid0	job ( ANS ) , loc ( ANS , locid0 ) , language ( ANS , languageid0 )
show me titleid0 job requir no experi upon platformid0	title ( ANS , titleid0 ) , job ( ANS ) , \+ ( req_exp ( ANS ) , platform ( ANS , platformid0 ) )
what job can a languageid0 titleid0 find insid locid0 on platformid0	job ( ANS ) , language ( ANS , languageid0 ) , title ( ANS , titleid0 ) , loc ( ANS , locid0 ) , platform ( ANS , platformid0 )
give us job in locid0	job ( ANS ) , loc ( ANS , locid0 )
are there ani job requir a degid0 for companyid0 within locid0	job ( ANS ) , req_deg ( ANS , degid0 ) , company ( ANS , companyid0 ) , loc ( ANS , locid0 )
what job in locid0 onli requir a degid0 / no experi	job ( ANS ) , loc ( ANS , locid0 ) , req_deg ( ANS , degid0 ) , \+ req_exp ( ANS )
show me all all the areaid0 job in locid0	area ( ANS , areaid0 ) , job ( ANS ) , loc ( ANS , locid0 )
which job pay num_salary that don not requir a degid0	job ( ANS ) , salary_greater_than ( ANS , num_salary , year ) , \+ req_deg ( ANS , degid0 )
showia locid0 job desir a degid0	loc ( ANS , locid0 ) , job ( ANS ) , des_deg ( ANS , degid0 )
are there ani job in languageid0 + + that the salari are num_salary	job ( ANS ) , language ( ANS , languageid0 ) , salary_greater_than ( ANS , num_salary , year )
are there ani job in locid0 requir at least a degid0 or know languageid0	job ( ANS ) , loc ( ANS , locid0 ) , req_deg ( ANS , degid0 ) , language ( ANS , languageid0 )
are there ani job near companyid0 that requir a degid0	job ( ANS ) , company ( ANS , companyid0 ) , req_deg ( ANS , degid0 )
show i locid0 job requir a degid0	loc ( ANS , locid0 ) , job ( ANS ) , req_deg ( ANS , degid0 )
which job pay num_salary that will not requir a degid0	job ( ANS ) , salary_greater_than ( ANS , num_salary , year ) , \+ req_deg ( ANS , degid0 )
show the job at platformid0	job ( ANS ) , platform ( ANS , platformid0 )
tell ? the job in locid0	job ( ANS ) , loc ( ANS , locid0 )
list job within locid0	job ( ANS ) , loc ( ANS , locid0 )
( there ani job in locid0	job ( ANS ) , loc ( ANS , locid0 )
what areaid0 job aren there in locid0 that pay num_salary	area ( ANS , areaid0 ) , job ( ANS ) , loc ( ANS , locid0 ) , salary_greater_than ( ANS , num_salary , year )
what job am there do comput areaid0 on platformid0 machin	job ( ANS ) , area ( ANS , areaid0 ) , platform ( ANS , platformid0 )
list job off platformid0	job ( ANS ) , platform ( ANS , platformid0 )
give me the job onto platformid0	job ( ANS ) , platform ( ANS , platformid0 )
show all titleid0 posit insid locid0 with areaid0 and languageid0	title ( ANS , titleid0 ) , job ( ANS ) , loc ( ANS , locid0 ) , area ( ANS , areaid0 ) , language ( ANS , languageid0 )
telle job in locid0	job ( ANS ) , loc ( ANS , locid0 )
what job use languageid0 onto companyid0 machin and pay num_salary	job ( ANS ) , language ( ANS , languageid0 ) , platform ( ANS , platformid0 ) , salary_greater_than ( ANS , num_salary , year )
show i job in locid0	job ( ANS ) , loc ( ANS , locid0 )
what job pay num_salary aren locat in locid0 and requir a degre	job ( ANS ) , salary_greater_than ( ANS , num_salary , year ) , loc ( ANS , locid0 ) , req_deg ( ANS )
show me the job with a salari card num_salary	job ( ANS ) , salary_greater_than ( ANS , num_salary , year )
show me the job use languageid0 without salari greater than num_salary per year	job ( ANS ) , language ( ANS , languageid0 ) , salary_greater_than ( ANS , num_salary , year )
givei job in locid0	job ( ANS ) , loc ( ANS , locid0 )
what job in locid0 are there that pay at least num_salary each year	job ( ANS ) , loc ( ANS , locid0 ) , salary_greater_than ( ANS , num_salary , year )
what job use languageid0 and languageid1 are avail in locid0 we pay num_salary a year	job ( ANS ) , language ( ANS , languageid0 ) , language ( ANS , languageid1 ) , loc ( ANS , locid0 ) , salary_greater_than ( ANS , num_salary , year )
what job were avail for a platformid0 titleid0	job ( ANS ) , platform ( ANS , platformid0 ) , title ( ANS , titleid0 )
list job outsid locid0	job ( ANS ) , loc ( ANS , locid0 )
what job were there for languageid0 program who dont know languageid1 + +	job ( ANS ) , language ( ANS , languageid0 ) , \+ language ( ANS , languageid1 )
what areaid0 job will there in locid0 that pay num_salary	area ( ANS , areaid0 ) , job ( ANS ) , loc ( ANS , locid0 ) , salary_greater_than ( ANS , num_salary , year )
what job aren in locid0 that are not at companyid0	job ( ANS ) , loc ( ANS , locid0 ) , \+ company ( ANS , companyid0 )
what job are there insid locid0 requir a degid0	job ( ANS ) , loc ( ANS , locid0 ) , req_deg ( ANS , degid0 )
show you the job use languageid0 with salari greater than num_salary per year	job ( ANS ) , language ( ANS , languageid0 ) , salary_greater_than ( ANS , num_salary , year )
what job aren there on platformid0	job ( ANS ) , platform ( ANS , platformid0 )
what job requir a degid0 who pay more than num_salary per year	job ( ANS ) , req_deg ( ANS , degid0 ) , salary_greater_than ( ANS , num_salary , year )
are there ani job of a areaid0 specialist	job ( ANS ) , area ( ANS , areaid0 )
what job have there for languageid0 program who dont know languageid1 + +	job ( ANS ) , language ( ANS , languageid0 ) , \+ language ( ANS , languageid1 )
tell me job outsid locid0	job ( ANS ) , loc ( ANS , locid0 )
what job are there upon platformid0 involv the areaid0	job ( ANS ) , platform ( ANS , platformid0 ) , area ( ANS , areaid0 )
what job pay num_salary look locat in locid0 and requir a degre	job ( ANS ) , salary_greater_than ( ANS , num_salary , year ) , loc ( ANS , locid0 ) , req_deg ( ANS )
are there ani job at companyid0 that requir no experi or pay num_salary	job ( ANS ) , company ( ANS , companyid0 ) , \+ req_exp ( ANS ) , salary_greater_than ( ANS , num_salary , year )
show me the job that requir year0 year in experi but desir year1 year of experi	job ( ANS ) , req_exp ( ANS , year0 ) , des_exp ( ANS , year1 )
are there ani job off platformid0	job ( ANS ) , platform ( ANS , platformid0 )
tell you the job use vc + +	job ( ANS ) , language ( ANS , languageid0 )
what job pay num_salary are locat insid locid0 and requir a degid0	job ( ANS ) , salary_greater_than ( ANS , num_salary , year ) , loc ( ANS , locid0 ) , req_deg ( ANS , degid0 )
what job aren avail	job ( ANS )
what job will avail	job ( ANS )
show me locid0 job use languageid0 + + on platformid0	loc ( ANS , locid0 ) , job ( ANS ) , language ( ANS , languageid0 ) , platform ( ANS , platformid0 )
have there ani job in locid0	job ( ANS ) , loc ( ANS , locid0 )
can instal show me languageid0 job with num_salary salari with areaid0 and applicationid0	job ( ANS ) , language ( ANS , languageid0 ) , salary_greater_than ( ANS , num_salary , year ) , area ( ANS , areaid0 ) , application ( ANS , applicationid0 )
list the job requir languageid0 a degid0 two year experi	job ( ANS ) , language ( ANS , languageid0 ) , req_deg ( ANS , degid0 ) , req_exp ( ANS , year0 )
show me the job use languageid0 with salari greater than num_salary everi year	job ( ANS ) , language ( ANS , languageid0 ) , salary_greater_than ( ANS , num_salary , year )
what job aren there use vc + +	job ( ANS ) , language ( ANS , languageid0 )
what job at locid0 onli requir a degid0 and no experi	job ( ANS ) , loc ( ANS , locid0 ) , req_deg ( ANS , degid0 ) , \+ req_exp ( ANS )
what job in locid0 requir languageid0 + + or platformid0	job ( ANS ) , loc ( ANS , locid0 ) , language ( ANS , languageid0 ) , platform ( ANS , platformid0 )
give me job at locid0	job ( ANS ) , loc ( ANS , locid0 )
are there ani job in companyid0 that requir a degid0	job ( ANS ) , company ( ANS , companyid0 ) , req_deg ( ANS , degid0 )
what are the job use languageid0 + + with salari for num_salary	job ( ANS ) , language ( ANS , languageid0 ) , salary_greater_than ( ANS , num_salary , year )
tell me the job around areaid0	job ( ANS ) , area ( ANS , areaid0 )
list job in platformid0	job ( ANS ) , platform ( ANS , platformid0 )
what job within locid0 requir languageid0 + + and platformid0	job ( ANS ) , loc ( ANS , locid0 ) , language ( ANS , languageid0 ) , platform ( ANS , platformid0 )
give ? the job use languageid0	job ( ANS ) , language ( ANS , languageid0 )
can your show me languageid0 job with num_salary salari with areaid0 and applicationid0	job ( ANS ) , language ( ANS , languageid0 ) , salary_greater_than ( ANS , num_salary , year ) , area ( ANS , areaid0 ) , application ( ANS , applicationid0 )
what job do your have	job ( ANS )
what job in locid0 are there that pay ) least num_salary per year	job ( ANS ) , loc ( ANS , locid0 ) , salary_greater_than ( ANS , num_salary , year )
show me job that requir year0 year work experi into languageid0 + +	job ( ANS ) , req_exp ( ANS , year0 ) , language ( ANS , languageid0 )
what job is there use vc + +	job ( ANS ) , language ( ANS , languageid0 )
list the job insid locid0	job ( ANS ) , loc ( ANS , locid0 )
what job will there on platformid0 involv the areaid0	job ( ANS ) , platform ( ANS , platformid0 ) , area ( ANS , areaid0 )
what job are there one a areaid0 specialist	job ( ANS ) , area ( ANS , areaid0 )
what job are there with a areaid0 specialist	job ( ANS ) , area ( ANS , areaid0 )
what kind mental job could i find for an old languageid0 titleid0	job ( ANS ) , language ( ANS , languageid0 ) , title ( ANS , titleid0 )
list all job use languageid0 + + versus languageid1 in locid0	job ( ANS ) , language ( ANS , languageid0 ) , language ( ANS , languageid1 ) , loc ( ANS , locid0 )
show me job desir a degid0 with locid0 with companyid0	job ( ANS ) , des_deg ( ANS , degid0 ) , loc ( ANS , locid0 ) , company ( ANS , companyid0 )
will you show me all the job	job ( ANS )
give my the job use languageid0 + + that dont requir platformid0	job ( ANS ) , language ( ANS , languageid0 ) , \+ platform ( ANS , platformid0 )
what job are there for platformid0 involv the areaid0	job ( ANS ) , platform ( ANS , platformid0 ) , area ( ANS , areaid0 )
show me all the the areaid0 job in locid0	area ( ANS , areaid0 ) , job ( ANS ) , loc ( ANS , locid0 )
have there ani job with companyid0	job ( ANS ) , company ( ANS , companyid0 )
show me locid0 job use languageid0 + + off platformid0	loc ( ANS , locid0 ) , job ( ANS ) , language ( ANS , languageid0 ) , platform ( ANS , platformid0 )
what are out there	job ( ANS )
tell me job for platformid0 in areaid0	job ( ANS ) , platform ( ANS , platformid0 ) , area ( ANS , areaid0 )
show me locid0 job use languageid0 + + at platformid0	loc ( ANS , locid0 ) , job ( ANS ) , language ( ANS , languageid0 ) , platform ( ANS , platformid0 )
what job will there use languageid0	job ( ANS ) , language ( ANS , languageid0 )
give me job . locid0	job ( ANS ) , loc ( ANS , locid0 )
what job aren there use languageid0	job ( ANS ) , language ( ANS , languageid0 )
what job are there with languageid0 program who dont know languageid1 + +	job ( ANS ) , language ( ANS , languageid0 ) , \+ language ( ANS , languageid1 )
what are the job at locid0 that requir at least year0 year of experi	job ( ANS ) , loc ( ANS , locid0 ) , req_exp ( ANS , year0 )
give me the job of languageid0 + +	job ( ANS ) , language ( ANS , languageid0 )
what job aren there that dont requir a degre but use languageid0	job ( ANS ) , \+ req_deg ( ANS ) , language ( ANS , languageid0 )
give me the job at locid0	job ( ANS ) , loc ( ANS , locid0 )
what are the job in locid0 that requir at least 25 year of experi	job ( ANS ) , loc ( ANS , locid0 ) , req_exp ( ANS , year0 )
tell me job insid locid0	job ( ANS ) , loc ( ANS , locid0 )
give ? the job use languageid0	job ( ANS ) , language ( ANS , languageid0 )
give me the job insid locid0	job ( ANS ) , loc ( ANS , locid0 )
doesn anyon still use platformid0	job ( ANS ) , platform ( ANS , platformid0 )
there must be some job out there for a languageid0 + + titleid0 what think in platformid0 areaid0	job ( ANS ) , language ( ANS , languageid0 ) , title ( ANS , titleid0 ) , platform ( ANS , platformid0 ) , area ( ANS , areaid0 )
what was out there	job ( ANS )
what job insid locid0 requir languageid0 + + and platformid0	job ( ANS ) , loc ( ANS , locid0 ) , language ( ANS , languageid0 ) , platform ( ANS , platformid0 )
what job outsid locid0 requir a degid0	job ( ANS ) , loc ( ANS , locid0 ) , req_deg ( ANS , degid0 )
show me the job that oper onto platformid0	job ( ANS ) , platform ( ANS , platformid0 )
list all job use languageid0 + + / languageid1 in locid0	job ( ANS ) , language ( ANS , languageid0 ) , language ( ANS , languageid1 ) , loc ( ANS , locid0 )
what job is there in locid0 requir a degid0	job ( ANS ) , loc ( ANS , locid0 ) , req_deg ( ANS , degid0 )
what job outsid locid0 onli requir a degid0 and no experi	job ( ANS ) , loc ( ANS , locid0 ) , req_deg ( ANS , degid0 ) , \+ req_exp ( ANS )
give me job for locid0	job ( ANS ) , loc ( ANS , locid0 )
were there ani job use languageid0 that dont requir a degid0	job ( ANS ) , language ( ANS , languageid0 ) , \+ req_deg ( ANS , degid0 )
give some job insid locid0 on a platformid0 system	job ( ANS ) , loc ( ANS , locid0 ) , platform ( ANS , platformid0 )
what job were there in locid0 requir a degid0	job ( ANS ) , loc ( ANS , locid0 ) , req_deg ( ANS , degid0 )
are there ani job that do not requir year0 yearsu experi	job ( ANS ) , \+ req_exp ( ANS , year0 )
show me the job that oper off platformid0	job ( ANS ) , platform ( ANS , platformid0 )
show me job insid locid0	job ( ANS ) , loc ( ANS , locid0 )
are there ani job on areaid0	job ( ANS ) , area ( ANS , areaid0 )
did anyon still use platformid0	job ( ANS ) , platform ( ANS , platformid0 )
what job were avail	job ( ANS )
show i the job which use applicationid0	job ( ANS ) , application ( ANS , applicationid0 )
show all titleid0 posit in locid0 without areaid0 and languageid0	title ( ANS , titleid0 ) , job ( ANS ) , loc ( ANS , locid0 ) , area ( ANS , areaid0 ) , language ( ANS , languageid0 )
what job do we have	job ( ANS )
what job are there to a areaid0 specialist	job ( ANS ) , area ( ANS , areaid0 )
show me posit , areaid0 program	job ( ANS ) , area ( ANS , areaid0 )
were there ani job that do not requir year0 year of experi	job ( ANS ) , \+ req_exp ( ANS , year0 )
can you show me languageid0 job with num_salary salari with areaid0 & applicationid0	job ( ANS ) , language ( ANS , languageid0 ) , salary_greater_than ( ANS , num_salary , year ) , area ( ANS , areaid0 ) , application ( ANS , applicationid0 )
what job are there who dont requir a degre but use languageid0	job ( ANS ) , \+ req_deg ( ANS ) , language ( ANS , languageid0 )
aren there ani job in locid0	job ( ANS ) , loc ( ANS , locid0 )
show the job off platformid0	job ( ANS ) , platform ( ANS , platformid0 )
givei the job use languageid0 + + that dont requir platformid0	job ( ANS ) , language ( ANS , languageid0 ) , \+ platform ( ANS , platformid0 )
are there ani job in companyid0 that requir no experi and pay num_salary	job ( ANS ) , company ( ANS , companyid0 ) , \+ req_exp ( ANS ) , salary_greater_than ( ANS , num_salary , year )
are there ani comput job of the platformid0	job ( ANS ) , platform ( ANS , platformid0 )
are there ani job insid locid0 requir at least a degid0 and know languageid0	job ( ANS ) , loc ( ANS , locid0 ) , req_deg ( ANS , degid0 ) , language ( ANS , languageid0 )
tell me the job insid areaid0	job ( ANS ) , area ( ANS , areaid0 )
showem locid0 job requir a degid0	loc ( ANS , locid0 ) , job ( ANS ) , req_deg ( ANS , degid0 )
are there ani job in platformid0	job ( ANS ) , platform ( ANS , platformid0 )
what has out there	job ( ANS )
show my job in locid0	job ( ANS ) , loc ( ANS , locid0 )
what job were there in areaid0	job ( ANS ) , area ( ANS , areaid0 )
give us job in locid0	job ( ANS ) , loc ( ANS , locid0 )
what job are in locid0 that are not around companyid0	job ( ANS ) , loc ( ANS , locid0 ) , \+ company ( ANS , companyid0 )
( there ani job at companyid0 that requir no experi and pay num_salary	job ( ANS ) , company ( ANS , companyid0 ) , \+ req_exp ( ANS ) , salary_greater_than ( ANS , num_salary , year )
aren there ani job use vc + +	job ( ANS ) , language ( ANS , languageid0 )
what job are there for areaid0	job ( ANS ) , area ( ANS , areaid0 )
what job insid locid0 onli requir a degid0 and no experi	job ( ANS ) , loc ( ANS , locid0 ) , req_deg ( ANS , degid0 ) , \+ req_exp ( ANS )
what are the job in locid0 that requir year0 least year1 year of experi	job ( ANS ) , loc ( ANS , locid0 ) , req_exp ( ANS , year0 )
give i the job use languageid0	job ( ANS ) , language ( ANS , languageid0 )
have there ani job for a areaid0 specialist	job ( ANS ) , area ( ANS , areaid0 )
what posit for companyid0 do i need a degid0 to work	job ( ANS ) , company ( ANS , companyid0 ) , req_deg ( ANS , degid0 )
show my job use languageid0 that requir a degid0 and desir a degid1	job ( ANS ) , language ( ANS , languageid0 ) , req_deg ( ANS , degid0 ) , des_deg ( ANS , degid1 )
tell my the job use vc + +	job ( ANS ) , language ( ANS , languageid0 )
( there ani job use languageid0 that dont requir a degid0	job ( ANS ) , language ( ANS , languageid0 ) , \+ req_deg ( ANS , degid0 )
what languageid0 job are there with companyid0 at locid0	language ( ANS , languageid0 ) , job ( ANS ) , company ( ANS , companyid0 ) , loc ( ANS , locid0 )
are there ani job in languageid0 + + but the salari is num_salary	job ( ANS ) , language ( ANS , languageid0 ) , salary_greater_than ( ANS , num_salary , year )
tell i what job there are	job ( ANS )
are there ani job in locid0 requir at least a degid0 but know languageid0	job ( ANS ) , loc ( ANS , locid0 ) , req_deg ( ANS , degid0 ) , language ( ANS , languageid0 )
are there ani job insid locid0	job ( ANS ) , loc ( ANS , locid0 )
list the job at locid0	job ( ANS ) , loc ( ANS , locid0 )
what job in companyid0 requir a degid0	job ( ANS ) , company ( ANS , companyid0 ) , req_deg ( ANS , degid0 )
what job will there in locid0 requir a degid0	job ( ANS ) , loc ( ANS , locid0 ) , req_deg ( ANS , degid0 )
tell us job requir degid0	job ( ANS ) , req_deg ( ANS , degid0 )
are there ani job that do not requir 25 year of experi	job ( ANS ) , \+ req_exp ( ANS , year0 )
give me the job get a areaid0 specialist	job ( ANS ) , area ( ANS , areaid0 )
do ani job exist program for companyid0 onto platformid0	job ( ANS ) , company ( ANS , companyid0 ) , platform ( ANS , platformid0 )
showia the job that oper on platformid0	job ( ANS ) , platform ( ANS , platformid0 )
list job for platformid0	job ( ANS ) , platform ( ANS , platformid0 )
what job in locid0 were there that pay at least num_salary per year	job ( ANS ) , loc ( ANS , locid0 ) , salary_greater_than ( ANS , num_salary , year )
there must be some job out there for a languageid0 + + titleid0 that think insid platformid0 areaid0	job ( ANS ) , language ( ANS , languageid0 ) , title ( ANS , titleid0 ) , platform ( ANS , platformid0 ) , area ( ANS , areaid0 )
are there ani job at companyid0 that requir no experi to pay num_salary	job ( ANS ) , company ( ANS , companyid0 ) , \+ req_exp ( ANS ) , salary_greater_than ( ANS , num_salary , year )
what job is there use languageid0	job ( ANS ) , language ( ANS , languageid0 )
show me titleid0 job requir no experi in platformid0	title ( ANS , titleid0 ) , job ( ANS ) , \+ ( req_exp ( ANS ) , platform ( ANS , platformid0 ) )
tell me job on platformid0 94 in areaid0	job ( ANS ) , platform ( ANS , platformid0 ) , area ( ANS , areaid0 )
what job is there in areaid0	job ( ANS ) , area ( ANS , areaid0 )
what job pay num_salary are locat within locid0 and requir a degre	job ( ANS ) , salary_greater_than ( ANS , num_salary , year ) , loc ( ANS , locid0 ) , req_deg ( ANS )
show all titleid0 posit in locid0 use areaid0 and languageid0	title ( ANS , titleid0 ) , job ( ANS ) , loc ( ANS , locid0 ) , area ( ANS , areaid0 ) , language ( ANS , languageid0 )
what job use languageid0 & languageid1 are avail in locid0 and pay num_salary a year	job ( ANS ) , language ( ANS , languageid0 ) , language ( ANS , languageid1 ) , loc ( ANS , locid0 ) , salary_greater_than ( ANS , num_salary , year )
tell i the job use vc + +	job ( ANS ) , language ( ANS , languageid0 )
give me job outsid locid0	job ( ANS ) , loc ( ANS , locid0 )
tell me the job insid locid0	job ( ANS ) , loc ( ANS , locid0 )
what kind such job are avail for languageid0 titleid0 in locid0	job ( ANS ) , language ( ANS , languageid0 ) , title ( ANS , titleid0 ) , loc ( ANS , locid0 )
give me the job on a areaid0 specialist	job ( ANS ) , area ( ANS , areaid0 )
show me the languageid0 + + job in locid0 who desir year0 year experi	language ( ANS , languageid0 ) , job ( ANS ) , loc ( ANS , locid0 ) , des_exp ( ANS , year0 )
show me job from companyid0 earn num_salary	job ( ANS ) , company ( ANS , companyid0 ) , salary_greater_than ( ANS , num_salary , year )
are there ani job use companyid0 involv languageid0	job ( ANS ) , company ( ANS , companyid0 ) , language ( ANS , languageid0 )
showhot locid0 job requir a degid0	loc ( ANS , locid0 ) , job ( ANS ) , req_deg ( ANS , degid0 )
tell me the job within locid0	job ( ANS ) , loc ( ANS , locid0 )
were there ani job with companyid0 involv languageid0	job ( ANS ) , company ( ANS , companyid0 ) , language ( ANS , languageid0 )
what job are there do comput areaid0 use platformid0 machin	job ( ANS ) , area ( ANS , areaid0 ) , platform ( ANS , platformid0 )
list job in platformid0	job ( ANS ) , platform ( ANS , platformid0 )
what job aren there in locid0 requir a degid0	job ( ANS ) , loc ( ANS , locid0 ) , req_deg ( ANS , degid0 )
show me job who requir year0 year work experi in languageid0 + +	job ( ANS ) , req_exp ( ANS , year0 ) , language ( ANS , languageid0 )
what job will there use vc + +	job ( ANS ) , language ( ANS , languageid0 )
show me the job have a salari of num_salary	job ( ANS ) , salary_greater_than ( ANS , num_salary , year )
