give ? the job in languageid0 + +	( answer ( job ANS ) ( language ANS languageid0 ) )
showia titleid0 job require no experience on platformid0	( answer ( title ANS titleid0 ) ( job ANS ) ( \+ ( ( req_exp ANS ) ( platform ANS platformid0 ) ) ) )
givei the job in languageid0 + +	( answer ( job ANS ) ( language ANS languageid0 ) )
were there any job use vc + +	( answer ( job ANS ) ( language ANS languageid0 ) )
are there any job in languageid0 + + becaus the salary is num_salary	( answer ( job ANS ) ( language ANS languageid0 ) ( salary_greater_than ANS num_salary year ) )
show me job realli require year0 year work experience in languageid0 + +	( answer ( job ANS ) ( req_exp ANS year0 ) ( language ANS languageid0 ) )
what kind of job can i find for an old languageid0 titleid0	( answer ( job ANS ) ( language ANS languageid0 ) ( title ANS titleid0 ) )
is there any job use vc + +	( answer ( job ANS ) ( language ANS languageid0 ) )
list all job use languageid0 + + and languageid1 at locid0	( answer ( job ANS ) ( language ANS languageid0 ) ( language ANS languageid1 ) ( loc ANS locid0 ) )
tell me what job there aren	( answer ( job ANS ) )
show you locid0 job use languageid0 + + on platformid0	( answer ( loc ANS locid0 ) ( job ANS ) ( language ANS languageid0 ) ( platform ANS platformid0 ) )
give i the job in languageid0 + +	( answer ( job ANS ) ( language ANS languageid0 ) )
what job use languageid0 for companyid0 machin and pay num_salary	( answer ( job ANS ) ( language ANS languageid0 ) ( platform ANS platformid0 ) ( salary_greater_than ANS num_salary year ) )
what job are there upon companyid0	( answer ( job ANS ) ( platform ANS platformid0 ) )
give me the job use languageid0 + + they dont require platformid0	( answer ( job ANS ) ( language ANS languageid0 ) ( \+ ( platform ANS platformid0 ) ) )
showia locid0 job require a degid0	( answer ( loc ANS locid0 ) ( job ANS ) ( req_deg ANS degid0 ) )
tell ? the job use vc + +	( answer ( job ANS ) ( language ANS languageid0 ) )
what are the job in locid0 that require app least year0 year of experience	( answer ( job ANS ) ( loc ANS locid0 ) ( req_exp ANS year0 ) )
are there any job in languageid0 + + where the salary is num_salary	( answer ( job ANS ) ( language ANS languageid0 ) ( salary_greater_than ANS num_salary year ) )
give me the job use languageid0 + + chunk dont require platformid0	( answer ( job ANS ) ( language ANS languageid0 ) ( \+ ( platform ANS platformid0 ) ) )
show me job that require year0 year work experience with languageid0 + +	( answer ( job ANS ) ( req_exp ANS year0 ) ( language ANS languageid0 ) )
showia job that require year0 year work experience in languageid0 + +	( answer ( job ANS ) ( req_exp ANS year0 ) ( language ANS languageid0 ) )
list all job use languageid0 + + and languageid1 for locid0	( answer ( job ANS ) ( language ANS languageid0 ) ( language ANS languageid1 ) ( loc ANS locid0 ) )
what job are there for companyid0	( answer ( job ANS ) ( platform ANS platformid0 ) )
are there any job in languageid0 + + that the salary are num_salary	( answer ( job ANS ) ( language ANS languageid0 ) ( salary_greater_than ANS num_salary year ) )
what do the job use languageid0 + + with salary of num_salary	( answer ( job ANS ) ( language ANS languageid0 ) ( salary_greater_than ANS num_salary year ) )
tell ? the job in locid0	( answer ( job ANS ) ( loc ANS locid0 ) )
what are the job use languageid0 + + for salary of num_salary	( answer ( job ANS ) ( language ANS languageid0 ) ( salary_greater_than ANS num_salary year ) )
what job use languageid0 onto companyid0 machin and pay num_salary	( answer ( job ANS ) ( language ANS languageid0 ) ( platform ANS platformid0 ) ( salary_greater_than ANS num_salary year ) )
show me the job use languageid0 without salary greater than num_salary per year	( answer ( job ANS ) ( language ANS languageid0 ) ( salary_greater_than ANS num_salary year ) )
tell you the job use vc + +	( answer ( job ANS ) ( language ANS languageid0 ) )
show me locid0 job use languageid0 + + on platformid0	( answer ( loc ANS locid0 ) ( job ANS ) ( language ANS languageid0 ) ( platform ANS platformid0 ) )
what job aren there use vc + +	( answer ( job ANS ) ( language ANS languageid0 ) )
what job in locid0 require languageid0 + + or platformid0	( answer ( job ANS ) ( loc ANS locid0 ) ( language ANS languageid0 ) ( platform ANS platformid0 ) )
what are the job use languageid0 + + with salary for num_salary	( answer ( job ANS ) ( language ANS languageid0 ) ( salary_greater_than ANS num_salary year ) )
what job within locid0 require languageid0 + + and platformid0	( answer ( job ANS ) ( loc ANS locid0 ) ( language ANS languageid0 ) ( platform ANS platformid0 ) )
give ? the job use languageid0	( answer ( job ANS ) ( language ANS languageid0 ) )
give my job in locid0	( answer ( job ANS ) ( loc ANS locid0 ) )
show me job that require year0 year work experience into languageid0 + +	( answer ( job ANS ) ( req_exp ANS year0 ) ( language ANS languageid0 ) )
what job is there use vc + +	( answer ( job ANS ) ( language ANS languageid0 ) )
what kind mental job could i find for an old languageid0 titleid0	( answer ( job ANS ) ( language ANS languageid0 ) ( title ANS titleid0 ) )
list all job use languageid0 + + versus languageid1 in locid0	( answer ( job ANS ) ( language ANS languageid0 ) ( language ANS languageid1 ) ( loc ANS locid0 ) )
what job do you ha	( answer ( job ANS ) )
give my the job use languageid0 + + that dont require platformid0	( answer ( job ANS ) ( language ANS languageid0 ) ( \+ ( platform ANS platformid0 ) ) )
show me locid0 job use languageid0 + + off platformid0	( answer ( loc ANS locid0 ) ( job ANS ) ( language ANS languageid0 ) ( platform ANS platformid0 ) )
show me locid0 job use languageid0 + + at platformid0	( answer ( loc ANS locid0 ) ( job ANS ) ( language ANS languageid0 ) ( platform ANS platformid0 ) )
what can i find use languageid0 off platformid0	( answer ( job ANS ) ( language ANS languageid0 ) ( platform ANS platformid0 ) )
give me the job of languageid0 + +	( answer ( job ANS ) ( language ANS languageid0 ) )
give ? the job use languageid0	( answer ( job ANS ) ( language ANS languageid0 ) )
what job insid locid0 require languageid0 + + and platformid0	( answer ( job ANS ) ( loc ANS locid0 ) ( language ANS languageid0 ) ( platform ANS platformid0 ) )
list all job use languageid0 + + / languageid1 in locid0	( answer ( job ANS ) ( language ANS languageid0 ) ( language ANS languageid1 ) ( loc ANS locid0 ) )
givei the job use languageid0 + + that dont require platformid0	( answer ( job ANS ) ( language ANS languageid0 ) ( \+ ( platform ANS platformid0 ) ) )
showem locid0 job require a degid0	( answer ( loc ANS locid0 ) ( job ANS ) ( req_deg ANS degid0 ) )
show my job in locid0	( answer ( job ANS ) ( loc ANS locid0 ) )
what were the job use languageid0 + + with salary of num_salary	( answer ( job ANS ) ( language ANS languageid0 ) ( salary_greater_than ANS num_salary year ) )
aren there any job use vc + +	( answer ( job ANS ) ( language ANS languageid0 ) )
what are the job in locid0 that require year0 least year1 year of experience	( answer ( job ANS ) ( loc ANS locid0 ) ( req_exp ANS year0 ) )
tell my the job use vc + +	( answer ( job ANS ) ( language ANS languageid0 ) )
are there any job in languageid0 + + but the salary is num_salary	( answer ( job ANS ) ( language ANS languageid0 ) ( salary_greater_than ANS num_salary year ) )
are there any job insid languageid0 + + that the salary is num_salary	( answer ( job ANS ) ( language ANS languageid0 ) ( salary_greater_than ANS num_salary year ) )
tell me job on platformid0 94 in areaid0	( answer ( job ANS ) ( platform ANS platformid0 ) ( area ANS areaid0 ) )
tell i the job use vc + +	( answer ( job ANS ) ( language ANS languageid0 ) )
showhot locid0 job require a degid0	( answer ( loc ANS locid0 ) ( job ANS ) ( req_deg ANS degid0 ) )
show me job who require year0 year work experience in languageid0 + +	( answer ( job ANS ) ( req_exp ANS year0 ) ( language ANS languageid0 ) )
what job will there use vc + +	( answer ( job ANS ) ( language ANS languageid0 ) )
