which area is the smallest	( argmin $0 ( state:t $0 ) ( size:i $0 ) )
what are the main river in s0	( lambda $0 e ( and ( major:t $0 ) ( river:t $0 ) ( loc:t $0 s0 ) ) )
what is the number of c0	( population:i c0 )
which state has the smallest averag urban popul	( argmin $0 ( state:t $0 ) ( density:i $0 ) )
which state has the smallest averag urban popul	( argmin $0 ( state:t $0 ) ( density:i $0 ) )
where is the smallest town	( lambda $0 e ( loc:t ( argmin $1 ( city:t $1 ) ( size:i $1 ) ) $0 ) )
what is the populac of s0	( population:i s0 )
what is the demograph of s0	( population:i s0 )
what state is the largest in populac	( argmax $0 ( state:t $0 ) ( population:i $0 ) )
which state has the most populac	( argmax $0 ( state:t $0 ) ( population:i $0 ) )
which state has the greatest populac	( argmax $0 ( state:t $0 ) ( population:i $0 ) )
what state is the largest in demograph	( argmax $0 ( state:t $0 ) ( population:i $0 ) )
which state has the biggest populac	( argmax $0 ( state:t $0 ) ( population:i $0 ) )
what is the capit of northern dakota	( capital:c s0 )
what is the biggest town in s0	( argmax $0 ( and ( city:t $0 ) ( loc:t $0 s0 ) ) ( size:i $0 ) )
what is the largest town in s0	( argmax $0 ( and ( city:t $0 ) ( loc:t $0 s0 ) ) ( size:i $0 ) )
what is the capit of newli jersey	( capital:c s0 )
which co0 has the most major citi	( argmax $0 ( state:t $0 ) ( count $1 ( and ( major:t $1 ) ( city:t $1 ) ( loc:t $1 $0 ) ) ) )
which counti has the most major citi	( argmax $0 ( state:t $0 ) ( count $1 ( and ( major:t $1 ) ( city:t $1 ) ( loc:t $1 $0 ) ) ) )
what are the capit of state that contact s0	( lambda $0 e ( and ( capital:t $0 ) ( exists $1 ( and ( state:t $1 ) ( next_to:t $1 s0 ) ( loc:t $0 $1 ) ) ) ) )
what state boundari s0	( lambda $0 e ( and ( state:t $0 ) ( next_to:t $0 s0 ) ) )
what citi has the most major citi	( argmax $0 ( state:t $0 ) ( count $1 ( and ( city:t $1 ) ( major:t $1 ) ( loc:t $1 $0 ) ) ) )
what state have citi titl c0	( lambda $0 e ( and ( state:t $0 ) ( exists $1 ( and ( city:t $1 ) ( named:t $1 n0 ) ( loc:t $1 $0 ) ) ) ) )
what is the smallest town in the co0	( argmin $0 ( and ( city:t $0 ) ( loc:t $0 co0 ) ) ( size:i $0 ) )
what is the smallest metropoli in the co0	( argmin $0 ( and ( city:t $0 ) ( loc:t $0 co0 ) ) ( size:i $0 ) )
what is the populac of s0	( population:i s0 )
what is the demograph of s0	( population:i s0 )
what is the capit of the state with the largest popul mass	( capital:c ( argmax $1 ( state:t $1 ) ( density:i $1 ) ) )
what state have citi titl plano	( lambda $0 e ( and ( state:t $0 ) ( exists $1 ( and ( city:t $1 ) ( named:t $1 n0 ) ( loc:t $1 $0 ) ) ) ) )
what citi border the state with the most citi	( lambda $0 e ( and ( state:t $0 ) ( next_to:t $0 ( argmax $1 ( state:t $1 ) ( count $2 ( and ( city:t $2 ) ( loc:t $2 $1 ) ) ) ) ) ) )
what is the populac of s0	( population:i s0 )
what nation border s0	( lambda $0 e ( and ( state:t $0 ) ( next_to:t $0 s0 ) ) )
which creek travers most state	( argmax $0 ( river:t $0 ) ( count $1 ( and ( state:t $1 ) ( loc:t $0 $1 ) ) ) )
what stream are in s0	( lambda $0 e ( and ( river:t $0 ) ( loc:t $0 s0 ) ) )
what waterway are in s0	( lambda $0 e ( and ( river:t $0 ) ( loc:t $0 s0 ) ) )
what counti is c0 in	( lambda $0 e ( and ( state:t $0 ) ( loc:t c0 $0 ) ) )
which co0 has the most river	( argmax $0 ( state:t $0 ) ( count $1 ( and ( river:t $1 ) ( loc:t $1 $0 ) ) ) )
what is the capit of the state with the most dweller	( capital:c ( argmax $1 ( state:t $1 ) ( population:i $1 ) ) )
which state has the most main river	( argmax $0 ( state:t $0 ) ( count $1 ( and ( major:t $1 ) ( river:t $1 ) ( loc:t $1 $0 ) ) ) )
which state has the lowest altitud	( argmin $0 ( state:t $0 ) ( elevation:i $0 ) )
amount of state border s0	( count $0 ( and ( state:t $0 ) ( next_to:t $0 s0 ) ) )
what is the most popul metropoli	( argmax $0 ( city:t $0 ) ( population:i $0 ) )
what citi has the most folk	( argmax $0 ( city:t $0 ) ( population:i $0 ) )
how high is hill mckinley	( elevation:i m0 )
how highest is m0	( elevation:i m0 )
how high is mt mckinley	( elevation:i m0 )
how high is mt mckinley	( elevation:i m0 )
which citi in s0 has the largest populac	( argmax $0 ( and ( city:t $0 ) ( loc:t $0 s0 ) ) ( population:i $0 ) )
how mani stream are in s0	( count $0 ( and ( river:t $0 ) ( loc:t $0 s0 ) ) )
what state boundari s0	( lambda $0 e ( and ( state:t $0 ) ( next_to:t $0 s0 ) ) )
which state capit has the smallest populac	( argmin $0 ( capital:t $0 ) ( population:i $0 ) )
which counti border s0	( lambda $0 e ( and ( state:t $0 ) ( next_to:t $0 s0 ) ) )
which state boundari s0	( lambda $0 e ( and ( state:t $0 ) ( next_to:t $0 s0 ) ) )
what is the smallest state near s0	( argmin $0 ( and ( state:t $0 ) ( next_to:t $0 s0 ) ) ( size:i $0 ) )
which state has the highest popul mass	( argmax $0 ( state:t $0 ) ( density:i $0 ) )
what is the popul of the state with the highest popul figur	( population:i ( argmax $0 ( state:t $0 ) ( density:i $0 ) ) )
what is the popul of the state with the highest popul mass	( population:i ( argmax $0 ( state:t $0 ) ( density:i $0 ) ) )
what state have citi titl c0	( lambda $0 e ( and ( state:t $0 ) ( exists $1 ( and ( city:t $1 ) ( named:t $1 n0 ) ( loc:t $1 $0 ) ) ) ) )
how mani state border the state with the largest populac	( count $0 ( and ( state:t $0 ) ( next_to:t $0 ( argmax $1 ( state:t $1 ) ( population:i $1 ) ) ) ) )
what state has the largest region	( argmax $0 ( state:t $0 ) ( area:i $0 ) )
what is the state with the largest region	( argmax $0 ( state:t $0 ) ( area:i $0 ) )
what state have citi titl c0	( lambda $0 e ( and ( state:t $0 ) ( exists $1 ( and ( city:t $1 ) ( named:t $1 n0 ) ( loc:t $1 $0 ) ) ) ) )
what is the populac of s0	( population:i s0 )
which state have citi titl c0	( lambda $0 e ( and ( state:t $0 ) ( exists $1 ( and ( city:t $1 ) ( named:t $1 n0 ) ( loc:t $1 $0 ) ) ) ) )
how mani river are in the nation that has the most river	( count $0 ( and ( river:t $0 ) ( loc:t $0 ( argmax $1 ( state:t $1 ) ( count $2 ( and ( river:t $2 ) ( loc:t $2 $1 ) ) ) ) ) ) )
what are the capit town in s0	( lambda $0 e ( and ( capital:t $0 ) ( loc:t $0 s0 ) ( city:t $0 ) ) )
what is the populac of s0	( population:i s0 )
what nation is c0 in	( lambda $0 e ( and ( state:t $0 ) ( loc:t c0 $0 ) ) )
what is the biggest town in s0	( argmax $0 ( and ( city:t $0 ) ( loc:t $0 s0 ) ) ( size:i $0 ) )
what is the longest stream in s0	( argmax $0 ( and ( river:t $0 ) ( loc:t $0 s0 ) ) ( len:i $0 ) )
what is the populac of s0	( population:i s0 )
what are the waterway in s0	( lambda $0 e ( and ( river:t $0 ) ( loc:t $0 s0 ) ) )
which state boundari the most state	( argmax $0 ( state:t $0 ) ( count $1 ( and ( state:t $1 ) ( next_to:t $0 $1 ) ) ) )
what is the highest hill in the co0	( argmax $0 ( and ( mountain:t $0 ) ( loc:t $0 co0 ) ) ( elevation:i $0 ) )
what state contain the highest point of those the r0 river travers	( lambda $0 e ( and ( state:t $0 ) ( loc:t ( argmax $1 ( and ( place:t $1 ) ( loc:t r0 $1 ) ) ( elevation:i $1 ) ) $0 ) ) )
what is the dens of the s0	( density:i s0 )
what is the mass of the s0	( density:i s0 )
what is the highest elev of san angel	( argmax $0 ( and ( place:t $0 ) ( loc:t $0 c0 ) ) ( elevation:i $0 ) )
how mani capit doe rhode island have	( count $0 ( and ( capital:t $0 ) ( loc:t $0 s0 ) ) )
how mani capit doe rhode isl have	( count $0 ( and ( capital:t $0 ) ( loc:t $0 s0 ) ) )
how mani capit doe rhode island have	( count $0 ( and ( capital:t $0 ) ( loc:t $0 s0 ) ) )
how long is the longest stream in s0	( len:i ( argmax $0 ( and ( river:t $0 ) ( loc:t $0 s0 ) ) ( len:i $0 ) ) )
what is the largest citi in rhode island	( argmax $0 ( and ( city:t $0 ) ( loc:t $0 s0 ) ) ( size:i $0 ) )
what is the largest citi in rhode island	( argmax $0 ( and ( city:t $0 ) ( loc:t $0 s0 ) ) ( size:i $0 ) )
what is the longest river in the big state	( argmax $0 ( and ( river:t $0 ) ( loc:t $0 ( argmax $1 ( state:t $1 ) ( size:i $1 ) ) ) ) ( len:i $0 ) )
how long is the longest creek in the co0	( len:i ( argmax $0 ( and ( river:t $0 ) ( loc:t $0 co0 ) ) ( len:i $0 ) ) )
st antonio is in what state	( lambda $0 e ( and ( state:t $0 ) ( loc:t c0 $0 ) ) )
what is the district of s0	( area:i s0 )
what is the region of s0	( area:i s0 )
what are the major town in s0	( lambda $0 e ( and ( major:t $0 ) ( city:t $0 ) ( loc:t $0 s0 ) ) )
which state is mt mckinley in	( lambda $0 e ( and ( state:t $0 ) ( loc:t m0 $0 ) ) )
which term border s0	( lambda $0 e ( and ( state:t $0 ) ( next_to:t $0 s0 ) ) )
how mani state doe s0 boundari	( count $0 ( and ( state:t $0 ) ( next_to:t s0 $0 ) ) )
what are the popul of the main citi of s0	( lambda $0 e ( exists $1 ( and ( city:t $1 ) ( major:t $1 ) ( loc:t $1 s0 ) ( population:t $1 $0 ) ) ) )
what are the populac of s0	( population:i s0 )
what state have citi name salt lake town	( lambda $0 e ( and ( state:t $0 ) ( exists $1 ( and ( city:t $1 ) ( named:t $1 n0 ) ( loc:t $1 $0 ) ) ) ) )
how highest is the highest point in s0	( elevation:i ( argmax $0 ( and ( place:t $0 ) ( loc:t $0 s0 ) ) ( elevation:i $0 ) ) )
what are the major town in s0	( lambda $0 e ( and ( major:t $0 ) ( city:t $0 ) ( loc:t $0 s0 ) ) )
what is the district of s0	( area:i s0 )
how big is texan	( size:i s0 )
what is the populac of the smallest state	( population:i ( argmin $0 ( state:t $0 ) ( size:i $0 ) ) )
